MS:  	 1823: 
[DELstart] sevr[DELend]  	 Every one adored Elizabeth. If the 
 make 	 make, 
[DELstart] the[DELend][DELstart]  For me I loved he[DELend][ADDstart] her[ADDend]  	 her intercession. 
  	[NO 1823 VARIANT]
[DELstart] There[DELend][ADDstart] There For, although[ADDend] was 	 and dispute; for although there was 
  yet 	 characters, 
diss  	 dissimilitude. 
phi losphical 	 philosophical 
companion  Yet I 	 companion; yet my temper 
[DELstart] n[DELend]  	[NO 1823 VARIANT]
 mild or 	[NO 1823 VARIANT]
endurance [DELstart] than hers[DELend]  	 endurance; 
[DELstart] as hers[DELend]  	[NO 1823 VARIANT]
[DELstart] lasted[DELend][ADDstart] endured[ADDend][ADDstart] X[ADDend] I 	 endured. I 
 relating 	 relative 
 world, 	 world; 
[ADDstart] ^[ADDend][ADDstart] following[ADDend]  	 following 
 aerial 	 aërial 
 poets.– 	 poets. 
 secret 	 secret, 
disco -ver,–to 	 discover; to 
[DELstart] haven[DELend] vacancy 	 vacancy, 
own.[DELstart] When I[DELend][DELstart] I had[DELend]  	 own.     
 myself 	 myself; 
[DELstart] who[DELend][DELstart] who[DELend]  	[NO 1823 VARIANT]
school  fellows 	 schoolfellows, 
 this. 	 this 
[DELstart] Carignan[DELend][ADDstart] Clerval[ADDend]  	 Clerval 
son[DELstart] s[DELend]  	 son 
[DELstart] an[DELend]  	[NO 1823 VARIANT]
Geneva [DELstart] and[DELend]  	 Geneva, 
father[DELstart] 's[DELend]  – he 	 father. He 
&[DELstart] fancy[DELend]  fancy 	 and fancy. 
 remember 	 remember, 
 only 	[NO 1823 VARIANT]
 old 	 old, 
 tale 	 tale, 
[DELstart] Like Don Quixote[DELend]  his 	 His 
[DELstart] was[DELend] consisted 	 consisted 
chi  valry & romance 	 chivalry and romance; 
[ADDstart] ^[ADDend] when 	 when 
can remember 	 can remember, 
[DELstart] favourite[DELend][ADDstart] ese[ADDend]  	 these favourite 
[DELstart] car[DELend] characters 	 characters 
 Orlando 	 Orlando, 
 Amadis 	 Amadis, 
 George– 	 George.     
 could be 	 have passed 
happy  	 happily 
– [DELstart] Our[DELend][ADDstart] My[ADDend]  	 My 
[DELstart] and our stud[DELend]  	[NO 1823 VARIANT]
 forced, 	 forced; 
 view 	 view, 
ardour.[ADDstart] ^[ADDend] in 	 ardour in 
[ADDstart] method[ADDend] not 	 method, and not 
 emulation 	 emulation, 
 urged. 	 urged to application. 
 told 	 incited 
 drawing 	 drawing, 
[DELstart] would[DELend] might 	 might 
 her, 	 her; 
[DELstart] she[DELend][DELstart] was[DELend][DELstart] knew how[DELend][ADDstart] by[ADDend][ADDstart] the[ADDend][ADDstart] desire of[ADDend]  	 through the desire of 
Aunt   	 aunt, 
[DELstart] a painting[DELend] the 	 the 
[DELstart] of her[DELend][DELstart] s[DELend]  	 favourite scene 
[DELstart] Latin[DELend]  	[NO 1823 VARIANT]
& English 	 and English, 
writ[DELstart] ers[DELend][ADDstart] ings[ADDend][ADDstart] in[ADDend]  	 writings in 
 languages 	 languages; 
 begin rendered 	 being made 
[DELstart] by[DELend]  	[NO 1823 VARIANT]
th[ADDstart] ^[ADDend][ADDstart] r[ADDend] punishment, 	 through punishment, 
 application 	 application, 
[DELstart] were[DELend] would 	 would 
 perhaps 	 Perhaps 
 books 	 books, 
[DELstart] a[DELend]  	[NO 1823 VARIANT]
 quickly 	 quickly, 
[DELstart] another child[DELend] those 	 those 
ordinary[ADDstart] method,[ADDend]  	 ordinary, methods; 
[DELstart] this[DELend][ADDstart] XX[ADDend][ADDstart] the[ADDend] tion 	 memories.     In this description 
include[DELstart] I include[DELend][DELstart] Hen[DELend]  	 include 
[DELstart] Carignan[DELend][DELstart] in this account[DELend][ADDstart] Clerval,[ADDend]  	 Clerval; 
[DELstart] con[DELend][ADDstart] ^[ADDend][ADDstart] he[ADDend]  	 he was 
 he 	 He 
[DELstart] sho[DELend]  	[NO 1823 VARIANT]
 me 	 me, 
 house 	 house; 
  	[NO 1823 VARIANT]
h[DELstart] to[DELend][ADDstart] is[ADDend]  	 his 
 house 	 house; 
 record 	 absent.   
those circumstances for that science which was 	 I feel pleasure in dwelling on 
 principal amusement 	 recollections 
my  ded 	 childhood, before misfortune had tainted 
destiny my taste for old books 	 mind, and changed its bright visions 
chemist ry and natural magic 	 extensive usefulness into gloomy 
I remem Pliny's Natural History 	 narrow reflections upon self. But, in drawing the picture of 
father  refusing to allow me 	 early days, I must not omit 
read a  translation. I used when very young 	 record those events which led, by insensible steps, 
 attend lectures 	 my after tale 
chemistry  given in Geneva and athough 	 misery: for when 
 did not understand them 	 would account to myself for 
 attract 	 birth of that passion, which afterwards ruled 
attention.[DELstart] I reme^mber[DELend][DELstart] also[DELend][DELstart] are[DELend][DELstart] caused[DELend][DELstart] by slight or[DELend][DELstart] s[DELend][DELstart] Strange as the[DELend][DELstart] statement of the[DELend][DELstart] simple fact[DELend][ADDstart] ^[ADDend][ADDstart] m[ADDend][ADDstart] derive thier origin from a[ADDend][ADDstart] ^[ADDend][ADDstart] statement of the[ADDend] may appear 	 destiny, I find it arise, like a mountain river, from ignoble and almost forgotten sources; but, swelling as it proceeded, it became the torrent which, in its course, has swept away all 
fate had been[DELstart] Chemist[DELend] ral 	 hopes and joys.     Natural 
[DELstart] has[DELend]  	[NO 1823 VARIANT]
 fate 	 fate; 
[DELstart] wish[DELend][ADDstart] desire[ADDend][ADDstart] refore[ADDend]  	 desire therefore, 
account  of my early years 	 narration, 
my[DELstart] love[DELend][DELstart] pursuit[DELend][DELstart] first aqu[DELend][DELstart] of that study.[DELend][ADDstart] first aqu[ADDend] predeliction 	 my predilection 
 eleven 	 thirteen 
 old 	 of age, 
[DELstart] Thonon[DELend] the 	 the 
near[DELstart] and were confined there[DELend][DELstart] b[DELend][DELstart] obil[DELend][ADDstart] Thonon.[ADDend] obliged by 	 near Thonon: 
rain[DELstart] and[DELend][ADDstart] T[ADDend] he 	[NO 1823 VARIANT]
[DELstart] fo[DELend][DELstart] s[DELend]  	 volume 
 Works 	 works 
[DELstart] And[DELend]  	[NO 1823 VARIANT]
apathy [DELstart] but[DELend][ADDstart] ^[ADDend] the 	 apathy; the 
 that 	 which 
 attempted 	 attempts 
d demonstrate 	 demonstrate, 
that[DELstart] chan[DELend]  	 which he relates, 
into[DELstart] continued to re with[DELend]  	 into 
 dawned 	 seemed to dawn 
mind and [DELstart] I[DELend][DELstart] com[DELend] bounding 	 mind; and, bounding 
 joy 	 joy, 
remark  ing 	[NO 1823 VARIANT]
[DELstart] parents[DELend][DELstart] have[DELend][ADDstart] ^[ADDend][ADDstart] instructors[ADDend][ADDstart] posess[ADDend] of 	 instructors possess of 
tit[DELstart] t[DELend] le page 	 title-page 
book — [DELstart] Ah[DELend]  	 book, 
 said Ah! 	 said, “Ah! 
 — 	[NO 1823 VARIANT]
 Victor 	 Victor, 
 this – 	 this; 
trash.  If 	 trash.”     If, 
remark or rather excla mation 	 remark, 
[DELstart] ound[DELend][ADDstart] ^[ADDend][ADDstart] lain[ADDend]  	 explain 
 me 	 me, 
  	[NO 1823 VARIANT]
exploded. [DELstart] And[DELend][DELstart] aan[DELend]  	 exploded, 
[DELstart] another[DELend][ADDstart] a modern[ADDend] system 	 a modern system 
 introduced 	 introduced, 
 power 	 powers 
 ancient 	 ancient, 
 ancient 	 latter 
pretended  and 	[NO 1823 VARIANT]
moderns  are 	 former were 
 circumstances 	 circumstances, 
 and 	 and, 
was[ADDstart] sh[ADDend] ould 	 was, should 
 aplied 	 applied 
[DELstart] m[DELend]  	[NO 1823 VARIANT]
[DELstart] ra[DELend]  	[NO 1823 VARIANT]
at present has 	[NO 1823 VARIANT]
discoveries[DELstart] the approbation of the learned.[DELend] It 	 discoveries. It 
 possible 	 possible, 
 might 	 would 
recieved that 	 received the 
 which 	 that 
 me 	[NO 1823 VARIANT]
[DELstart] the[DELend][ADDstart] ^[ADDend][ADDstart] its[ADDend]  	 its 
 greatest 	 greadest 
 When 	    When 
[DELstart] this[DELend][ADDstart] ^[ADDend][ADDstart] the[ADDend][ADDstart] ^[ADDend][ADDstart] whole[ADDend]  	 the whole 
 author 	 author, 
 those 	[NO 1823 VARIANT]
studi the 	 studied the 
 authors 	 writers 
 delight, 	 delight; 
 besides 	 beside 
and, althoug I 	 and although I 
[DELstart] discover[DELend][ADDstart] communicate[ADDend]  	 communicate 
[DELstart] from[DELend]  	[NO 1823 VARIANT]
 father 	 father, 
in definite 	 indefinite 
 favorite Agrippa, 	 favourite Agrippa 
[DELstart] I let[DELend]  	[NO 1823 VARIANT]
 secret 	 discoveries 
 Elizabeth 	 Elizabeth, 
 strict 	[NO 1823 VARIANT]
[DELstart] them[DELend] the 	 the 
– It 	    It 
 strange 	 strange, 
desci ple 	 disciple 
 century, 	 century; 
[DELstart] did[DELend][ADDstart] had[ADDend]  	 had 
  	[NO 1823 VARIANT]
  	[NO 1823 VARIANT]
 reality, 	 reality; 
 greates 	 greatest 
  	[NO 1823 VARIANT]
 philosophers 	 philosopher’s 
[DELstart] elizer vi[DELend][ADDstart]   or if you chose petrum philosophale [ADDend] elixer 	 elixir 
life[DELstart] tæ[DELend] . 	 life. 
undi ved attention; 	 undivided attention: 
 object 	 object; 
 would be the 	[NO 1823 VARIANT]
  of 	 would attend 
 discovery 	 discovery, 
[DELstart] besto[DELend][DELstart] forever[DELend] banish 	 banish 
 frame 	 frame, 
[DELstart] unatainable[DELend] invunerable 	 invulnerable 
  	[NO 1823 VARIANT]
death. Nor 	 death!     Nor 
 visions, the 	 visions. The 
[DELstart] was also a favour[DELend][ADDstart] ^[ADDend] was 	 was 
by[DELstart] ite[DELend][DELstart] pursuit[DELend][DELstart] and[DELend][DELstart] If I never saw any[DELend] my 	 by my 
 authors; 	 authors, 
sought; & 	 sought; and 
unsuccessful attributed 	 unsuccessful, I attributed 
[DELstart] th[DELend]  	[NO 1823 VARIANT]
[ADDstart] ^[ADDend] to 	 to 
[ADDstart] ^[ADDend] or 	 or 
instructor[DELstart] When I was about fifteen my f[DELend][ADDstart] s[ADDend] The 	 instructors.     The 
 phænonema 	 phenomena 
 takes 	 take 
[DELstart] I remember[DELend][DELstart] The[DELend][DELstart] fermentation[DELend][DELstart] of liquors[DELend][DELstart] di[DELend]  	 Distillation, and the wonderful effects of steam, processes 
 favorite 	 favourite 
  ignorant 	 ignorant, 
 astonishment, 	 astonishment; 
[DELstart] caused[DELend][DELstart] by an[DELend] engaged 	 engaged 
experiements[DELstart] air pump[DELend][DELstart] electrical machine[DELend][ADDstart] electrical machine[ADDend] on 	 experiments on 
air pump which 	 airpump, which 
[DELstart] used[DELend][ADDstart] employed[ADDend]  	 employed 
visiting. The 	 visiting.     The 
 my 	 the early 
 points, 	 points 
[ADDstart] ^[ADDend][ADDstart] thier[ADDend]  	 their 
[ADDstart] ^[ADDend][ADDstart] me[ADDend]  – 	 me: 
 aside 	 aside, 
[DELstart] any[DELend][DELstart] some[DELend]  	[NO 1823 VARIANT]
[DELstart] cocc[DELend][ADDstart] should[ADDend][ADDstart] y[ADDend] d 	 should occupy 
place[ADDstart] ,[ADDend]  	 place 
mind–  	 mind. 
[[ADDstart] W[ADDend] hen 	 When 
[DELstart] twelve[DELend][ADDstart] fourteen[ADDend]  	 fifteen 
 old 	 old, 
 were at 	 had retired to 
 Belrive 	 Belrive, 
[DELstart] the[DELend]  	[NO 1823 VARIANT]
thunder storm it 	 thunder-storm. It 
Jura   	 the mountains of Jura; 
[DELstart] the d[DELend][DELstart] several quarte[DELend][DELstart] rs[DELend]  	[NO 1823 VARIANT]
[DELstart] and[DELend][ADDstart] ^[ADDend] from 	 frightful loudness from 
heavens  	 heavens. 
[DELstart] storm with pleasure[DELend][ADDstart] e[ADDend][ADDstart] ed[ADDend]  	 remained, 
lasted [DELstart] at[DELend][ADDstart] watching its[ADDend]  	 lasted, watching 
[DELstart] the door[DELend][DELstart] watchin[DELend][DELstart] g[DELend][DELstart] When it was most[DELend] As 	 and delight. As 
door[DELstart] violent[DELend] on 	 door, on 
[DELstart] the[DELend][ADDstart] ^[ADDend] a 	 a 
[DELstart] be[DELend]  	[NO 1823 VARIANT]
 oak 	 oak, which stood 
[DELstart] wh[DELend]  	[NO 1823 VARIANT]
 house 	 house; 
[DELstart] when[DELend] so 	 so 
[DELstart] dazz[DELend] dazzling 	 dazzling 
[DELstart] had[DELend][DELstart] dissa[DELend][DELstart] dissappeared[DELend][DELstart] the[DELend][DELstart] pa[DELend]  	[NO 1823 VARIANT]
[DELstart] hand[DELend][ADDstart] &[ADDend][ADDstart] remained[ADDend]  	 had disappeared, and nothing remained 
[DELstart] rent[DELend][ADDstart] ^[ADDend][ADDstart] blasted[ADDend]  	 blasted 
[DELstart] remained[DELend] . 	[NO 1823 VARIANT]
 morning 	 morning, 
[DELstart] trea[DELend]  	[NO 1823 VARIANT]
[DELstart] The[DELend][DELstart] C[DELend]  	[NO 1823 VARIANT]
 saw 	 beheld 
 the 	 this 
astonish[DELstart] and[DELend][DELstart] caused[DELend][DELstart] me to aply wi[DELend][DELstart] ith[DELend][DELstart] fresh di[DELend][DELstart] chemistry[DELend][DELstart] clamatio[DELend][DELstart] di[DELend][DELstart] endeavou[DELend][DELstart] to[DELend][ADDstart] ^[ADDend][ADDstart] induced[ADDend][ADDstart] natural philosophy[ADDend][ADDstart] i[ADDend]  	 astonishment; 
elements to ascertain [ADDstart] ^[ADDend][ADDstart] Among other questions suggested by natural objects[ADDend]  	[NO 1823 VARIANT]
[DELstart] as[DELend]  	[NO 1823 VARIANT]
 enquired 	 inquired 
[DELstart] what[DELend][ADDstart] ^[ADDend] the 	 the 
 & the 	 and 
lightening. [DELstart] was.[DELend]  	 lightning. 
 electricity; 	 “Electricity;” 
 effect 	 various effects 
[DELstart] made[DELend][ADDstart] constructed[ADDend] a 	 constructed a 
 machine 	 machine, 
 experiments and 	 experiments; he 
 kite 	 kite, 
[DELstart] and[DELend][ADDstart] &[ADDend][ADDstart] which[ADDend]  	 and string, which 
clouds. This 	 clouds.     This 
[DELstart] blow[DELend][DELstart] st[DELend]  	[NO 1823 VARIANT]
 compleated 	 completed 
 Magnus 	 Magnus, 
 enclined 	 inclined 
 system 	 system; 
[DELstart] inclination[DELend][ADDstart] disinclination[ADDend]  	 disinclination 
 My 	 circumstance.     My 
I [ADDstart] ^[ADDend][ADDstart] cheerfully[ADDend] house of Clerval's father 	[NO 1823 VARIANT]
[DELstart] O P[DELend][DELstart] h[DELend][DELstart] if any one would him I went[DELend][DELstart] but[DELend][ADDstart] t[ADDend] Some 	 cheerfully consented. Some 
the [DELstart] series of[DELend]  	[NO 1823 VARIANT]
lectures[DELstart] this lecture was unfortunately nearly the[DELend][DELstart] they were nearly over [DELend][DELstart] they[DELend]  it 	 lectures until the course 
finihsed. The[DELstart] last[DELend][DELstart] the[DELend]  almost 	 finished. The lecture being, therefore, one of 
last [DELstart] in his[DELend] was 	 last, was 
 – the 	 The 
 talked 	 discoursed 
&[DELstart] zinc bismuth[DELend]  – 	 and boron, 
 sulphats and oxids 	 sulphates 
displayed so many[DELstart] words[DELend][ADDstart] terms[ADDend]  	 oxyds, terms 
[DELstart] not[DELend]  	[NO 1823 VARIANT]
[DELstart] any[DELend][DELstart] that[DELend][ADDstart] no[ADDend]  	 no idea; and 
 was 	 became 
appearance[DELstart] of[DELend][DELstart] chemistry[DELend] the 	[NO 1823 VARIANT]
philosophy  	 philosophy, 
 with delight 	[NO 1823 VARIANT]
Buffons [DELstart] that stood about on a par[DELend] in 	 Buffon with delight, authors, in 
 estimation 	 estimation, 
& utility.[DELstart] studies[DELend][ADDstart] occupations[ADDend]  	 and utility.     My occupations 
[DELstart] th[DELend]  	[NO 1823 VARIANT]
[DELstart] which I delighted in an[DELend]  	[NO 1823 VARIANT]
[DELstart] th[DELend]  	[NO 1823 VARIANT]
 also 	[NO 1823 VARIANT]
 languages 	 languages; 
[ADDstart] ^[ADDend][ADDstart] already[ADDend]  	 already 
 me 	 me, 
 without the help 	 some 
[DELstart] dictionary[DELend][ADDstart] lexicon[ADDend]  some of 	 easiest Greek authors without 
 easiest greek authors. –I 	 help of a lexicon. I 
English&[DELstart] ese[DELend][DELstart] are[DELend][ADDstart] is[ADDend][ADDstart] is[ADDend]  	 English and German. This is the 
[DELstart] that[DELend][DELstart] time[DELend][DELstart] e period[DELend]  	[NO 1823 VARIANT]
 employd 	 employed 
  	[NO 1823 VARIANT]
  	[NO 1823 VARIANT]
 Another 	 Another 
[DELstart] soon[DELend][ADDstart] ^[ADDend][ADDstart] also[ADDend]  	 also 
 me 	 me, 
 five 	 six 
 aflicted 	 afflicted 
infancy [ADDstart] thro which[ADDend] Elizabeth 	 infancy, through which Elizabeth 
[DELstart] m[DELend][DELstart] I[DELend]  	 nurses; 
 gentle 	 gentle, 
 William 	 William, 
 family 	 family, 
 quite a child 	 yet an infant, 
 world, 	 world; 
 eyes 	 eyes, 
cheeks  	 cheeks, 
[DELstart] affectionate[DELend]  	[NO 1823 VARIANT]
 manners 	 manners, 
 circle 	 circle, 
[DELstart] f[DELend]  	[NO 1823 VARIANT]
 studies 	 studies, 
[DELstart] we were all equal[DELend][DELstart] we none[DELend][ADDstart] neither[ADDend]  	 Neither 
 preheminence 	 the slightest pre-eminence 
other  	 other; 
 among us 	 amongst us; 
with[ADDstart] ,[ADDend][ADDstart] to[ADDend] obey 	 with and obey 
[ADDstart] 3[ADDend] When 	 W HEN  
 seventeen 	 seventeen, 
[DELstart] father[DELend][ADDstart] parents[ADDend]  	 parents 
[DELstart]  to[DELend] become 	 become 
In- golstadt. 	 Ingolstadt. 
 Geneva, 	 Geneva; 
 necessary 	 necessary, 
[DELstart] that[DELend]  	 education, 
[DELstart] besides[DELend][ADDstart] than[ADDend] those 	 than those 
[DELstart] for[DELend]  	[NO 1823 VARIANT]
[ADDstart] ^[ADDend][ADDstart] date.[ADDend]  But 	 date; but, 
 arrive 	 arrive, 
occurred: [DELstart] as if[DELend] omen 	 occurred—an omen, 
were  	 were, 
misery >Elizabeth 	 misery.     Elizabeth 
 fever 	 fever; 
[DELstart] [DELend]  	[NO 1823 VARIANT]
 severe 	 severe, 
confinement [DELstart] mady[DELend][DELstart] made[DELend][ADDstart] ^[ADDend][ADDstart] made many[ADDend] guments 	 confinement, many arguments 
[DELstart] not[DELend] to 	 to 
 to attend 	 attending 
 had 	 had, at first, 
[DELstart] the[DELend][DELstart] to these[DELend] to 	 to 
entreaties,  	 entreaties; 
[DELstart] ha[DELend]  	[NO 1823 VARIANT]
 sick 	[NO 1823 VARIANT]
[DELstart] it was safe[DELend] the 	 the 
  	[NO 1823 VARIANT]
 fatal: on 	 fatal. On 
 sickened. Her 	 sickened; her 
[DELstart] very[DELend][DELstart] tr[DELend]  	 very malignant, 
[DELstart] wort[DELend]  	[NO 1823 VARIANT]
 evil. 	 event. 
 death bed 	 death-bed 
[DELstart] di[DELend]  	[NO 1823 VARIANT]
[DELstart] my mother[DELend] this 	 this 
woman did 	 woman did 
myself. "My  "children said 	 myself: “My children,” 
it was on your  "union that my 	 said, “my 
 "future 	 future 
placed. It  "will 	 placed on the prospect of your union. This expectation will 
[DELstart] fathor[DELend][DELstart] alone[DELend][ADDstart] alone[ADDend]  	 your father. 
 "love, 	 love, you must 
[DELstart] the other[DELend][DELstart] cons[DELend]  	 your younger 
[DELstart] almost[DELend]  	[NO 1823 VARIANT]
[DELstart] being[DELend] than 	 that 
you, [DELstart] h[DELend]  and 	 you; and, 
 beloved, 	 beloved 
am  "is 	 have been, is 
 "these 	 these 
me [ADDstart] ^[ADDend] will 	 me; I will 
[DELstart] to[DELend]  	[NO 1823 VARIANT]
 "death 	 death, 
[DELstart] my[DELend][DELstart] beloved[DELend][DELstart] creatures[DELend]  	[NO 1823 VARIANT]
 "in 	 in 
world." She 	 world.”     She 
 calmly 	 calmly; 
 features 	 countenance 
[DELstart] lov[DELend]  	[NO 1823 VARIANT]
  	[NO 1823 VARIANT]
 irreperable evil; 	 irreparable evil, 
[DELstart] bla[DELend]  	[NO 1823 VARIANT]
 every where 	[NO 1823 VARIANT]
[DELstart] their[DELend][DELstart] minds[DELend][ADDstart] ^[ADDend][ADDstart] the soul[ADDend]  	 the soul, 
 they 	 we 
 theirs, 	 our own, 
ever:  hat 	 ever—that 
 loved 	 beloved 
[DELstart] faded[DELend] been 	 been 
[DELstart] never[DELend] so familiar 	 so familiar, 
 ear 	 ear, 
 days. But 	 days; but 
 evil 	 evil, 
[DELstart] true[DELend][DELstart] despair[DELend] bitterness 	 actual bitterness 
commences[DELstart] Then the survivors dare not turn[DELend][DELstart] But[DELend][ADDstart] ,[ADDend] Yet, 	 commences. Yet 
 who 	[NO 1823 VARIANT]
  	[NO 1823 VARIANT]
connection,  	 connexion; 
[DELstart] need[DELend][ADDstart] should[ADDend]  	 should 
[DELstart] But[DELend][ADDstart] T[ADDend] he 	 The 
 arrives 	 arrives, 
[DELstart] a[DELend]  	[NO 1823 VARIANT]
 necessity 	 necessity; 
 on 	 upon 
 is 	 may be 
 sacriledge, 	 a sacrilege, 
Ba nished.– 	 banished. 
gone[DELstart] had be[DELend][DELstart] en[DELend][DELstart] taken[DELend][DELstart] away[DELend][ADDstart] lost[ADDend][ADDstart] ^[ADDend][ADDstart] was dead[ADDend]  	 dead, 
  	[NO 1823 VARIANT]
 perform 	 perform; 
[DELstart] & bless God if nothing[DELend][DELstart] else[DELend][DELstart] worse[DELend][DELstart] .[DELend][ADDstart] ^[ADDend][ADDstart] worse[ADDend] and 	[NO 1823 VARIANT]
idleness generated by grief would[DELstart] become a bad habit if further indulged[DELend][ADDstart] become a bad habit if further indulged[ADDend] and 	 rest, and 
our  	 ourselves fortunate, 
seized. My 	 seized.     My 
 Ingolstadt 	 Ingolstadt, 
 events 	 events, 
upon, [DELstart] and all that[DELend][DELstart] could[DELend]  	 upon. I 
[DELstart] was[DELend][ADDstart] a[ADDend] respite 	 a respite 
 time 	 period 
 sadly. My mothers death 	 sadly ; my mother’s death, 
 departure 	 departure; 
 spirits 	 spirits; 
[DELstart] spr[DELend][DELstart] renew[DELend][DELstart] the spirit[DELend][DELstart] cast aa gleam[DELend][ADDstart] cast aa gleam[ADDend] renew 	 renew 
cheer  fullness 	 cheerfulness 
 aunt 	 aunt, 
[DELstart] firmess[DELend]  	[NO 1823 VARIANT]
 exactitude 	 exactness; 
[DELstart] her[DELend] she 	 she 
the  	[NO 1823 VARIANT]
duty [DELstart] was[DELend][DELstart] to[DELend][ADDstart] of[ADDend]  	 duty, of 
hap  	 happy, 
 on 	 upon 
[DELstart] and[DELend]  	[NO 1823 VARIANT]
 brothers 	 brothers; 
 time 	 time, 
[DELstart] e[DELend][DELstart] of her time[DELend][DELstart] to others[DELend][ADDstart] ^[ADDend][ADDstart] was[ADDend] ly 	 was continually 
 others 	 others, 
  	 of herself. 
[DELstart] hels[DELend] The 	 The 
lenghth  arrived – 	 length arrived. 
 friends 	 friends, 
[DELstart] not able[DELend][ADDstart] unable[ADDend]  	 unable 
 me But 	 me: but 
[DELstart] bear[DELend] be 	 be 
him [DELstart] besides[DELend][DELstart] as[DELend][DELstart] he[DELend][DELstart] him to[DELend][ADDstart] ing[ADDend] that 	 him, intending, that 
should come 	 should become 
 his 	[NO 1823 VARIANT]
and [DELstart] he said he did not[DELend][DELstart] and[DELend]  	[NO 1823 VARIANT]
[DELstart] the[DELend]  	[NO 1823 VARIANT]
 superflous 	 superfluous 
life.[DELstart] see[DELend][DELstart] ^of[DELend][DELstart] what use learning[DELend][DELstart] was[DELend][DELstart] could be[DELend][DELstart] to a[DELend][DELstart] merchant.[DELend][ADDstart] ^[ADDend][ADDstart] of[ADDend][ADDstart] ^[ADDend][ADDstart] could be[ADDend]  	 life. 
mind [DELstart] and a[DELend]  	 mind; 
[DELstart] did not wish[DELend] had 	 had 
 idle 	 idle, 
[DELstart] of[DELend]  	[NO 1823 VARIANT]
father's [ADDstart] ^[ADDend][ADDstart] partner[ADDend] but 	 father’s partner, but 
 trader 	 trader, 
[DELstart] have[DELend][ADDstart] posess[ADDend]  	 possess 
[DELstart] mind.[DELend][ADDstart] understanding.[ADDend] We sate late 	 understanding.     We sat late, 
[DELstart] I[DELend]  	[NO 1823 VARIANT]
[DELstart] and[DELend][ADDstart] T[ADDend] he 	 The 
 Elizabeth 	 Elizabeth; 
 before 	 before, 
 mothers 	 mother’s 
me  	 me. 
 away 	 away, 
 I 	 I, 
[DELstart] ed[DELend]  	[NO 1823 VARIANT]
 give 	 bestow 
 pleasure; 	 pleasure, 
the university [DELstart] wi[DELend]  	 th e niversity, 
 going 	 going, 
 friends 	 friends, 
[DELstart] introduction[DELend][ADDstart] protector.[ADDend]  	 protector. 
 retired 	 secluded 
 domestic 	 domestic; 
 an 	[NO 1823 VARIANT]
[DELstart] faces[DELend] countenances. 	 countenances. 
brothers Eliza beth 	 brothers, Elizabeth, 
 Clerval 	 Clerval; 
 "old 	 “old 
 faces" 	 faces;” 
 journey But 	 journey; but 
 proceeded 	 proceeded, 
knowledge [DELstart] and I[DELend] I 	 the acquisition of knowledge. I 
 often 	 often, 
 home 	 home, 
[DELstart] how[DELend][ADDstart] it[ADDend]  hard 	[NO 1823 VARIANT]
was  	 hard 
place   	 place, 
 into 	[NO 1823 VARIANT]
[DELstart] worth[DELend]  world 	 world, 
[DELstart] place[DELend][DELstart] with[DELend] station 	 station 
[DELstart] And[DELend] now 	 Now 
[DELstart] cop[DELend][ADDstart] &[ADDend]  	 complied with, and 
would [DELstart] indeed[DELend][ADDstart] ^[ADDend][ADDstart] indeed[ADDend][ADDstart] have[ADDend]  	 would, indeed, have 
 I 	 repent.     I 
[DELstart] plenty of[DELend][ADDstart] sufficient[ADDend]  	 sufficient 
  	[NO 1823 VARIANT]
 Ingolstadt 	 Ingolstadt, 
 fatiguing – at 	 fatiguing. At 
 steeples 	 high white steeple 
 alighted 	 alighted, 
 apartment 	 apartment, 
  	[NO 1823 VARIANT]
 The 	 The 
 introduction 	 introduction, 
 professors. 	 professors, 
[DELstart] Krempe[DELend][ADDstart] Krempe[ADDend] Professor 	 Krempe, professor 
[DELstart] & Lecturer[DELend][DELstart] upon[DELend]  Natural 	 natural 
[DELstart] sciences[DELend]  	[NO 1823 VARIANT]
 true 	 true, 
[ADDstart] ^[ADDend][ADDstart] ever[ADDend]  	 ever 
stared. [DELstart] "[DELend] "your 	 stared: “Have you,” he said, “really spent your 
 "nonsence?" 	 nonsense?”     
affir "Every minute"– 	 affirmative. “Every minute,” 
 with warmth," every 	 Krempe with warmth, “every 
 "you 	 you 
 upon 	 on 
 "books 	 books 
 "You 	 You 
[DELstart] bur[DELend][DELstart] memor[DELend]  	[NO 1823 VARIANT]
 "systems 	 systems, 
[DELstart] where must you[DELend] in 	 God! in 
 desart 	 desert 
 "lived 	 lived, 
 "enough 	 enough 
[DELstart] enfor[DELend]  	[NO 1823 VARIANT]
 "that 	 that 
 fancies 	 fancies, 
[ADDstart] ^[ADDend][ADDstart] you[ADDend]  	 you 
 "so 	 so 
 imbibed 	 imbibed, 
[DELstart] at le[DELend]  	[NO 1823 VARIANT]
 "thousand 	 thousand 
 old 	 old, 
[DELstart] your[DELend]  	[NO 1823 VARIANT]
 ancient. 	 ancient? 
 "in 	 in 
 "to 	 to 
Mag "nus 	 Magnus 
sir  "you 	 Sir, you 
 anew." 	 anew.”     
 saying 	 saying, 
ste[ADDstart] pp[ADDend] ed 	 stept 
[DELstart] wh[DELend]  	[NO 1823 VARIANT]
[DELstart] u[DELend]  upon 	 treating of 
 philosophy 	 philosophy, 
 procure 	 procure, 
 me 	 me, 
[DELstart] he intended[DELend][DELstart] to commen[DELend]  	[NO 1823 VARIANT]
 next 	 following 
  	[NO 1823 VARIANT]
relations; and 	 relations, and 
W.[ADDstart] ^[ADDend][ADDstart] aldham[ADDend]  	 Waldman, 
 fellow professor 	 fellow-professor, 
 which 	 that 
missed. I 	 missed.     I 
 home 	 home, 
 dissapointed 	 disappointed, 
 the 	 those 
 which 	 whom 
 reprobated – 	 reprobated; 
 very 	[NO 1823 VARIANT]
 enclined 	 inclined 
[DELstart] bu[DELend]  	[NO 1823 VARIANT]
 those 	 the 
[DELstart] recon[DELend] procured. 	 recommendation. 
 man 	 man, 
 countenance and 	 countenance; 
 teacher 	 teacher, therefore, 
  	[NO 1823 VARIANT]
[DELstart] science[DELend][DELstart] But when the ne[DELend][ADDstart] doctrine.[ADDend] sides 	 doctrine. Besides, 
[DELstart] chemistry[DELend] natural 	 natural 
[DELstart] when[DELend]  different 	 different, 
the[DELstart] n[DELend]  	 the 
[DELstart] wealth[DELend][ADDstart] power[ADDend] ;– 	 power; 
 views 	 views, 
 futile 	 futile, 
 grand; 	 grand: 
[DELstart] all[DELend][DELstart] t and the expulsion[DELend] greatness in 	 changed. The ambition of 
science[DELstart] those[DELend][DELstart] utmost[DELend][ADDstart] those[ADDend] enquirer 	 inquirer 
 grandeur, 	 grandeur 
worth. Such 	 worth.     Such 
[DELstart] tw[DELend]  	 the first 
[ADDstart] ^[ADDend][ADDstart] spent[ADDend]  	 spent 
[DELstart] solitary[DELend][DELstart] at[DELend][ADDstart] in[ADDend]  	 in solitude. But 
 ensueing 	 ensuing 
 commenced 	 commenced, 
M[ADDstart] rempe[ADDend]  	 which M. Krempe 
 lectures, and 	 lectures. And 
[ADDstart] ^[ADDend] out 	 out 
pulpit  	 pulpit, 
M . Waldham, 	 M. Waldman, 
seen [DELstart] and[DELend]  	 seen, 
 hitherto 	[NO 1823 VARIANT]
town.[DELstart] Half out of[DELend] Partly 	 town.     Partly 
 curiosity 	 curiosity, 
 idleness 	 idleness, 
 room 	 room, 
M . Waldham 	 M. Waldman 
 Professor 	 professor 
 a 	[NO 1823 VARIANT]
dif[DELstart] the other[DELend] his 	 unlike his 
 was 	 appeared 
 benevolence 	 benevolence; 
grey [DELstart] hars[DELend]  	 gray 
temples  	 temples, 
 He 	 His person 
short in  person 	 short, 
erect [DELstart] ha[DELend]  	 erect; 
with a [DELstart] kind[DELend] by 	 by 
  	[NO 1823 VARIANT]
[DELstart] & discoveries[DELend][ADDstart] ^[ADDend][ADDstart] & discoveries[ADDend] made 	 made 
various  	 different 
[DELstart] had made[DELend][ADDstart] of learning[ADDend]  pronoucing 	 of learning, pronouncing with fervour 
greatest discoverers [DELstart] with great warmth[DELend] . 	 most distinguished discoverers. 
[DELstart] chemistry[DELend] the 	 the 
[DELstart] termes[DELend]  	 elementary 
[DELstart] made[DELend][ADDstart] After making[ADDend]  	 After having made 
experiments [DELstart] and[DELend][ADDstart] he[ADDend] ded 	 experiments, he concluded 
[ADDstart] ^[ADDend][ADDstart] modern[ADDend] ry 	 modern chemistry, 
 words 	 terms 
 "The 	 forget:—     “The 
 science" 	 science,” 
"promised impossibilities  "and 	 “promised impossibilities, and 
 "masters 	 masters 
little. They [DELstart] no[DELend]  	 little; they 
 "transmuted 	 transmuted, 
[DELstart] vitæ[DELend] of 	 of 
[DELstart] mere[DELend]  chimæra. 	 chimera. 
 "these philosophers 	 these philosophers, 
[DELstart] eyes[DELend]  	[NO 1823 VARIANT]
 "appear 	 seem 
 "dirt 	 dirt, 
 "the 	 the 
cruscible,  "have 	 crucible, have 
 "They 	 They 
 "nature 	 nature, 
 "in 	 in 
[ADDstart] ;[ADDend] – 	 the heavens: 
 discoverd 	 discovered 
 "the 	 the 
 "of 	 of 
[DELstart] New[DELend]  	[NO 1823 VARIANT]
 "acquired 	 acquired 
powers[ADDstart] ;[ADDend][ADDstart] y[ADDend]  	 powers; they 
 "thunders 	 thunders 
 mimick 	 mimic 
 "earthquake, 	 earthquake, 
 "invisible 	 invisible 
 I 	 shadows.”     I 
lecture & paid 	 lecture, and paid 
[ADDstart] ^[ADDend] & 	 and 
 public. For 	 public; for 
 manner 	 mien 
 lectures 	 lecture, 
[DELstart] affabity[DELend] affability 	 affability 
kindness in his own  house. 	 kindness. 
 studies with attention 	 studies, and 
Paracelsus[ADDstart] X[ADDend]  	 Paracelsus, 
 Mr 	 M. 
[DELstart] Ex[DELend][DELstart] exhibited[DELend][ADDstart] expressed to them[ADDend][ADDstart] ^[ADDend] He said 	 exhibited. He said, 
 these 	 “these 
[DELstart] chem[DELend][ADDstart] natural[ADDend] philosophers 	 modern philosophers 
knowledge[ADDstart] ^[ADDend][ADDstart] had[ADDend] left 	 knowledge. They had left 
 task 	 task, 
 & 	 and 
conected classi fications 	 connected classifications, 
 to 	 in 
 genius 	 genius, 
 directed 	 directed, 
failed. in 	 fail in 
 I 	 mankind.” I 
state ment 	 statement, 
[DELstart] I ended by saying[DELend]  	 or affectation; and then added, 
 prejudice 	 prejudices 
 chemists 	 chemists; 
I request ed 	 I, 
 time 	 time, requested 
procure  	 procure. 
 "I 	 “I 
 happy" 	 happy,” 
M "have 	 M. Waldman, “to have 
[DELstart] desci[DELend]  desciple 	 disciple; 
 if 	[NO 1823 VARIANT]
[DELstart] appil[DELend]  	[NO 1823 VARIANT]
ability  "I 	 ability, I 
 "philosophy 	 philosophy 
[ADDstart] ^[ADDend][ADDstart] been[ADDend] & 	 been and 
made.  "It 	 made: it 
account[DELstart] s[DELend]  	 account 
I "chose 	 I have made 
 for 	[NO 1823 VARIANT]
study. But  "at 	 study; but at 
[ADDstart] ^[ADDend][ADDstart] time[ADDend]  	 time 
 did 	 have 
 neglect 	 neglected 
 "other sciences. 	 other branches of science. 
 "a 	 but a 
 atteneded 	 attended 
  	[NO 1823 VARIANT]
 "your 	 your 
 really 	[NO 1823 VARIANT]
 "man 	 man 
 science 	 science, 
 "a pretty experimentalist 	 a petty experimentalist, 
[ADDstart] s[ADDend] e 	 advise 
 "branch 	 branch 
philosophy [DELstart] and[DELend][ADDstart] including[ADDend] He 	 philosophy, including mathematics.”     He 
[DELstart] workroom[DELend][ADDstart] laboratory[ADDend] shewed 	 laboratory, 
explain  ed 	 explained 
 use 	 uses 
machines instructing 	 machines; instructing 
[DELstart] should[DELend][DELstart] procure[DELend] ought 	 ought 
procure[DELstart] for my priva[DELend]  	 procure, 
[DELstart] a lone[DELend]  	[NO 1823 VARIANT]
far[DELstart] e[DELend]  	 far 
 study 	 science 
[DELstart] der[DELend]  	[NO 1823 VARIANT]
[ADDstart] ir[ADDend][ADDstart] ^[ADDend][ADDstart] mechanism.[ADDend]  	 their mechanism. 
 requested 	 requested; 
leave. Thus 	 leave.     Thus 
[DELstart] in a my life[DELend][ADDstart] to me[ADDend]  for 	 to me: 
 From 	 From 
 philosophy 	 philosophy, 
 chemistry 	 chemistry, in the most comprehensive sense of the term, 
[ADDstart] ^[ADDend][ADDstart] nearly[ADDend]  	 nearly 
[DELstart] appli[DELend] study. 	 occupation. 
[DELstart] m[DELend]  	[NO 1823 VARIANT]
 books 	 works, 
discrimination [DELstart] at have been written[DELend]  	 discrimination, which modern inquirers have written 
 acquaintance 	 acquaintance, 
M  	 M. 
 & 	 and 
information  combined 	 information, combined, 
 true 	 true, 
 phisiognomy & 	 physiognomy and 
[DELstart] dg[DELend] dogmatism 	 dogmatism; 
 nature 	 nature, 
[DELstart] pedantl[DELend]  	[NO 1823 VARIANT]
 was perhaps 	 was, perhaps, 
 enclined 	 inclined 
 the study of 	[NO 1823 VARIANT]
[DELstart] science[DELend][ADDstart] ^[ADDend] natural 	 natural 
professed  	 professed, 
[DELstart] circumstance[DELend][DELstart] was had[DELend] state 	 state 
[DELstart] was[DELend]  	[NO 1823 VARIANT]
the  knowledge; 	 knowledge: 
[DELstart] more fully[DELend]  	[NO 1823 VARIANT]
[DELstart] the[DELend][DELstart] philosophy[DELend][ADDstart] science [ADDend]  	 the science, 
[DELstart] studied[DELend]  	[NO 1823 VARIANT]
 application 	 application, 
[DELstart] ch[DELend]  	[NO 1823 VARIANT]
[ADDstart] ^[ADDend] & 	 and 
 eager 	 eager, 
[ADDstart] ^[ADDend] in 	 disappeared in 
 while 	 whilst 
[DELstart] labouring[DELend][ADDstart] engaged[ADDend] in 	 engaged in 
labrotary.  	 laboratory. 
[DELstart] It[DELend]  	[NO 1823 VARIANT]
 students, 	 students; 
 proficiency 	 proficiency, 
master. [DELstart] and[DELend]  	 masters. 
 me 	 me, 
 smile 	 smile, 
on[ADDstart] ;[ADDend][ADDstart] ^[ADDend] while 	 on? whilst 
 Waldham 	 Waldman 
 manner 	 manner, 
[DELstart] ws[DELend]  	[NO 1823 VARIANT]
 engaged 	 engaged, 
 soul 	 soul, 
 discoveries 	 discoveries, 
[DELstart] No one[DELend]  	[NO 1823 VARIANT]
 it 	 them 
science–[DELstart] especially[DELend]  	 science. 
 you 	 you, 
[DELstart] learn[DELend][ADDstart] know,[ADDend]  learn, 	 know; 
[DELstart] their[DELend]  	[NO 1823 VARIANT]
[DELstart] even[DELend]  	[NO 1823 VARIANT]
 capacity who 	 capacity, which 
 study 	 study, 
 study—And I 	 study; and I, 
[DELstart] was[DELend]  	[NO 1823 VARIANT]
[DELstart] applied to[DELend] sought 	 sought 
[DELstart] thing[DELend][ADDstart] object [ADDend][ADDstart] pursuit[ADDend]  	 object of pursuit, 
[DELstart] as I was[DELend]  	[NO 1823 VARIANT]
this [DELstart] I[DELend][ADDstart] sole[ADDend]  	 this, 
 rapidly that 	 rapidly, that, 
 the 	[NO 1823 VARIANT]
 years 	 years, 
[DELstart] one or two[DELend][DELstart] trifling[DELend][ADDstart] some[ADDend]  	 some 
[DELstart] machines[DELend][ADDstart] instruments[ADDend]  	 instruments, 
[ADDstart] ^[ADDend] point, 	 point, 
learned  all 	 become as well acquainted with 
professors [DELstart] that[DELend][DELstart] at In[DELend][DELstart] golstadt was[DELend][ADDstart] y[ADDend] there 	 theory and practice of natural philosophy as depended on the lessons of any of the professors at Ingolstadt, my residence there 
 improvement, 	 improvements, 
 to 	[NO 1823 VARIANT]
stay. One 	 stay.     One 
 those phænonoma 	 the phenomena 
[DELstart] most[DELend][ADDstart] st[ADDend]  	[NO 1823 VARIANT]
 frame; and indeed that of 	 frame, and, indeed, 
 Whence 	 Whence, 
 myself 	 myself, 
 this 	 the 
 proceed. 	 proceed? 
[DELstart] that[DELend][ADDstart] which[ADDend] has 	 which has 
mystery.  Yet 	 mystery; yet with 
 on 	 upon 
 acquainted with 	 acquainted, 
enquiries? . 	 inquiries. 
 mind 	 mind, 
 from 	[NO 1823 VARIANT]
[DELstart] treats[DELend] relate 	 relate 
 phisiology. 	 physiology. 
 irksome 	 irksome, 
life [DELstart] de[DELend]  	 life, 
[DELstart] recou[DELend]  	[NO 1823 VARIANT]
[DELstart] No is ano anatomy[DELend]  	[NO 1823 VARIANT]
 anatomy 	 anatomy: 
 sufficient. 	 sufficient; 
 & 	 and 
  	[NO 1823 VARIANT]
[DELstart] not[DELend]  	[NO 1823 VARIANT]
by [ADDstart] ^[ADDend][ADDstart] no[ADDend]  	 with no 
 having 	 to have 
ghost story tale 	 tale 
superstition  	 superstition, 
spirit [DELstart] Ligh[DELend]  	 spirit. 
 fancy 	 fancy; 
[ADDstart] ^[ADDend][ADDstart] as[ADDend]  	[NO 1823 VARIANT]
[DELstart] rotten b[DELend] bodies 	 bodies 
life and [DELstart] becoming[DELend][ADDstart] which[ADDend] from 	 life, which, from 
&[ADDstart] ^[ADDend][ADDstart] become[ADDend]  	 and strength, had become 
[DELstart] But[DELend][DELstart] I [DELend][DELstart] A loathsome[DELend][DELstart] But[DELend]  now 	 Now 
[DELstart] obliged[DELend][ADDstart] led[ADDend]  	 led 
[DELstart] cause[DELend][ADDstart] cause[ADDend] & 	 cause and 
 decay 	 decay, 
Charnel [DELstart] was obliged[DELend]  	 charnel-houses. 
[DELstart] horror of whic[DELend][DELstart] calculated to[DELend][ADDstart] object calculated to[ADDend] the 	 object the 
of the 	 of the 
[DELstart] are suscept[DELend][DELstart] able[DELend] – 	[NO 1823 VARIANT]
[DELstart] a[DELend]  	[NO 1823 VARIANT]
[DELstart] was[DELend][DELstart] became[DELend][ADDstart] became[ADDend][ADDstart] was[ADDend]  	 was 
 wasted. 	 wasted; 
 life – 	 life; 
worm[ADDstart] inherited[ADDend]  	 worm inherited 
anal[DELstart] yzed[DELend][DELstart] every[DELend][DELstart] minutiæ[DELend][DELstart]  of [DELend][DELstart] causation[DELend][ADDstart] yzing[ADDend] all 	 analysing all 
 causation 	 causation, 
& death 	 and death 
 untill 	 until 
me.  A 	 me—a 
 & wondrous 	 and wondrous, 
  	[NO 1823 VARIANT]
 simple 	 simple, 
 I 	 I 
 surprised 	 surprised, 
I [DELstart] was[DELend]  	[NO 1823 VARIANT]
 applied to 	 directed their inquiries towards 
 science 	 science, 
 this 	 so 
secret. Remember 	 a secret.     Remember, 
[ADDstart] ^[ADDend][ADDstart] not[ADDend]  	 not 
[DELstart] no[DELend]  	[NO 1823 VARIANT]
[DELstart] of[DELend]  	[NO 1823 VARIANT]
 madman – the 	 madman. The 
 heavens 	 heavens, 
wh[ADDstart] ich[ADDend] I 	 which I 
[DELstart] record[DELend][ADDstart] affirm,[ADDend]  	 affirm 
 it. But 	 it, yet 
[DELstart] toil[DELend][ADDstart] labour[ADDend]  	 labour 
 fatigue 	 fatigue, 
 & life. Nay 	 and life; nay, 
[DELstart] was[DELend][ADDstart] became[ADDend]  	 became 
[DELstart] My[DELend]  	 matter.     
surprise [DELstart] that[DELend][ADDstart] which[ADDend]  	 astonishment which 
[ADDstart] ^[ADDend][ADDstart] at first[ADDend] experienced 	 had at first experienced 
such  After 	[NO 1823 VARIANT]
 time 	 time 
labour[DELstart] come[DELend] to 	 labour, to 
 onece 	 once 
[DELstart] obj ect[DELend][DELstart] object[DELend][ADDstart] summit[ADDend]  	 summit 
 desires 	 desires, 
circumstance  that could have occurred. 	 consummation of my toils. 
overwhelm ing 	 overwhelming, 
[DELstart] the[DELend]  	[NO 1823 VARIANT]
  	[NO 1823 VARIANT]
[DELstart] that[DELend] by 	 by 
been progressively 	 been progressively 
[DELstart] saw[DELend][ADDstart] ^[ADDend][ADDstart] and[ADDend][ADDstart] ^[ADDend][ADDstart] beheld[ADDend]  	 obliterated, and I beheld 
[DELstart] m[DELend]  	[NO 1823 VARIANT]
 world 	 world, 
[DELstart] hands.[DELend][ADDstart] ^[ADDend][ADDstart] grasp;[ADDend]  	 grasp. 
[DELstart] sceen[DELend]  scene 	 scene, 
on[ADDstart] c[ADDend][ADDstart] .[ADDend] on 	 once: 
contrary[DELstart] big[DELend][ADDstart] T[ADDend]  	[NO 1823 VARIANT]
[ADDstart] ^[ADDend] of 	 of 
[ADDstart] ^[ADDend][ADDstart] to[ADDend]  	 to 
endeavours. [ADDstart] ^[ADDend] so 	 endeavours so 
[DELstart] ,[DELend]  	 Arabian 
 life 	 life, 
 glimmering 	 glimmering, 
ineffectual light. I 	 ineffectual, light.     I 
 eargerness 	 eagerness, 
[DELstart] scret[DELend]  	[NO 1823 VARIANT]
acquainted[DELstart] but you are[DELend][ADDstart] ;[ADDend] that 	 acquainted; that 
be.[DELstart] mistaken[DELend][DELstart] .[DELend]  Listen 	 be: listen 
 to 	 until 
 story 	 story, 
[DELstart] For why shoul[DELend][DELstart] d[DELend]  	 subject. 
[DELstart] as[DELend]  	[NO 1823 VARIANT]
[DELstart] destruct[DELend]  	[NO 1823 VARIANT]
&  	 and 
 precepts 	 precepts, 
exam  ple, 	 example, 
 knowledge 	 knowledge, 
[DELstart] whonto[DELend] aspires 	 who aspires 
[DELstart] allows.[DELend]  	[NO 1823 VARIANT]
  	[NO 1823 VARIANT]
 When 	 When 
[DELstart] this[DELend][ADDstart] so[ADDend][ADDstart] a[ADDend]  	 so astonishing a 
[DELstart] use[DELend] manner 	 manner 
[DELstart] make of[DELend][ADDstart] employ[ADDend]  	 employ 
[DELstart] conceived myself capable of[DELend]  	[NO 1823 VARIANT]
 animation 	 animation, 
[DELstart] my[DELend]  	[NO 1823 VARIANT]
[DELstart] create[DELend][ADDstart] ^[ADDend][ADDstart] prepare[ADDend]  	 prepare 
[DELstart] creature[DELend][ADDstart] frame[ADDend][ADDstart] ^[ADDend] for 	 frame for 
[DELstart] receiving i[DELend][ADDstart] reception of[ADDend][ADDstart] it[ADDend]  	 reception of it, 
fibres muscles & veins [DELstart] must be[DELend][ADDstart] still remained[ADDend] a 	 fibres, muscles, and veins, still remained a 
[ADDstart] 2[ADDend][ADDstart] 1[ADDend] . 	 difficulty and labour. 
[DELstart] creature[DELend][DELstart] unto[DELend][ADDstart] being[ADDend]  myself 	 being like myself, 
[DELstart] b[DELend]  	[NO 1823 VARIANT]
[DELstart] capacity[DELend] ability 	 ability 
[DELstart] create[DELend][DELstart] creature[DELend][DELstart] being[DELend][ADDstart] give life[ADDend][ADDstart] to[ADDend][ADDstart] ^[ADDend]  	 give life to 
[DELstart] but[DELend][DELstart] But[DELend][DELstart] when I[DELend][DELstart] when[DELend][DELstart] I[DELend][DELstart] looked around for[DELend][DELstart] considered[DELend][DELstart] my[DELend][DELstart] materials[DELend][DELstart] they[DELend][ADDstart] Yet[ADDend][ADDstart] But[ADDend][ADDstart] considered[ADDend] The 	 The 
 ardous 	 arduous 
I did not despai but 	[NO 1823 VARIANT]
ul[ADDstart] -timately succeed.[ADDend] but 	 ultimately succeed. 
looked around on I 	[NO 1823 VARIANT]
 reverses, 	 reverses; 
[DELstart] might[DELend][DELstart] ever[DELend] incessantly, & 	 might be incessantly baffled, and 
 but imperfect, 	 imperfect: 
con the 	 considered the 
[DELstart] that[DELend][ADDstart] which[ADDend]  	 which 
[DELstart] and m my attempt was so much grande[DELend][DELstart] r[DELend][ADDstart] mechanics[ADDend] I 	 mechanics, I 
hope[DELstart] and[DELend] And altho although I could not 	[NO 1823 VARIANT]
  	[NO 1823 VARIANT]
[DELstart] s[DELend][DELstart] at le[DELend][DELstart] be in every[DELend][ADDstart] at le[ADDend] at 	 at 
[ADDstart] ^[ADDend][ADDstart] lay[ADDend]  	 lay 
success[DELstart] way perfect yet[DELend][DELstart] but[DELend][ADDstart] but[ADDend] Nor, 	 success. Nor 
 I did not think that 	[NO 1823 VARIANT]
[DELstart] grandeur[DELend][ADDstart] complexity[ADDend]  	 complexity 
[DELstart] w[DELend] as 	 as 
[DELstart] And[DELend][ADDstart] I[ADDend] t 	 It 
[ADDstart] ^[ADDend][ADDstart] that[ADDend] I 	 that I 
[DELstart] smallness[DELend][ADDstart] minuteness[ADDend]  	 minuteness 
[DELstart] were[DELend][ADDstart] formed[ADDend]  	 formed 
 speed 	 speed, 
[DELstart] him[DELend][DELstart] of[DELend][ADDstart] the being[ADDend]  	 the being 
 say 	 say, 
[ADDstart] ^[ADDend][ADDstart] seven[ADDend]  or 	[NO 1823 VARIANT]
[DELstart] And[DELend] after 	 After 
 determination 	 determination, 
[DELstart] collecting[DELend] successfully 	 successfully 
&  	 and arranging 
began. No 	 began.     No 
[DELstart] my[DELend]  	[NO 1823 VARIANT]
 pressed upon 	 bore 
[ADDstart] ^[ADDend][ADDstart] to[ADDend] enthusiasm life 	 onwards, like a hurricane, in the first enthusiasm of success. Life 
[ADDstart] thro,[ADDend]  	 through, 
[DELstart] creation[DELend][ADDstart] existence[ADDend]  	 species 
[DELstart] maker[DELend]  	 creator 
[DELstart] creatures[DELend][DELstart] beings[DELend][ADDstart] beings[ADDend][ADDstart] natures[ADDend]  	 natures 
[DELstart] existence[DELend][ADDstart] being[ADDend]  	 being 
[DELstart] in manner[DELend][DELstart] in a manner[DELend]  no 	 No 
 so 	 so 
[DELstart] And[DELend] sueing 	 theirs. Pursuing 
reflections [DELstart] if[DELend]  	 reflections, 
 thought 	 thought, 
[DELstart] life[DELend][ADDstart] animation[ADDend]  upon 	 animation 
 matter 	 matter, 
  	[NO 1823 VARIANT]
corruption. These 	 corruption.     These 
 spirits 	 spirits, 
[DELstart] labours[DELend][ADDstart] ^[ADDend][ADDstart] undertaking[ADDend] with 	 undertaking with 
[DELstart] eagerness[DELend][ADDstart] ^[ADDend][ADDstart] ardour[ADDend] . 	 ardour. 
[DELstart] was[DELend] had 	 had 
[DELstart] pe[DELend]  	[NO 1823 VARIANT]
[ADDstart] became[ADDend] emaciated by 	 had become emaciated with 
 sometimes 	 Sometimes, 
 certainty 	 certainty, 
 faild 	 failed; 
 still 	[NO 1823 VARIANT]
[DELstart] nexhour[DELend]  	[NO 1823 VARIANT]
[DELstart] knew[DELend][ADDstart] possessed[ADDend]  	 possessed 
 clung 	 had dedicated myself; 
labours  while 	 labours, while, 
 & 	 and 
 eagerness 	 eagerness, 
[DELstart] . But[DELend] who 	 hiding-places. Who 
[DELstart] know[DELend][ADDstart] ^[ADDend] concieve 	 conceive 
[DELstart] operatio[DELend][ADDstart] toil[ADDend] as 	 toil, as 
[DELstart] animate to ani[DELend]  	[NO 1823 VARIANT]
[DELstart] Now[DELend]  my 	 My 
 tremble 	 tremble, 
 rememberance, 	 remembrance; 
 resistless 	 resistless, 
[DELstart] all[DELend]  	[NO 1823 VARIANT]
frantic[ADDstart] ^[ADDend][ADDstart] impulse[ADDend]  	 frantic impulse, 
 trance 	 trance, 
renew ed 	 renewed 
[DELstart] when[DELend] so 	 so 
as  	 as, 
sti [DELstart] had[DELend][ADDstart] ing[ADDend][ADDstart] had[ADDend]  	 stimulus ceasing 
 and 	[NO 1823 VARIANT]
 Charnel houses 	 charnel-houses; 
fingers  meddled with 	 fingers, 
 chamber–or 	 chamber, or 
 cell 	 cell, 
 house 	 house, 
 seperated 	 separated 
 appartments 	 apartments 
 staircase 	 staircase, 
[DELstart] h[DELend]  	[NO 1823 VARIANT]
 creation; 	 creation: 
 minutiæ 	 details 
[DELstart] the[DELend]  	[NO 1823 VARIANT]
 slaughter house 	 slaughter-house 
 materials, 	 materials; 
[DELstart] but[DELend][DELstart] wal[DELend][DELstart] was[DELend][ADDstart] whilst[ADDend]  	 occupation, whilst, 
 encreased, 	 increased, 
[DELstart] drew[DELend]  	[NO 1823 VARIANT]
[ADDstart] ^[ADDend][ADDstart] to[ADDend]  	 to 
conclusion.[DELstart] sums[DELend]  Summer 	 conclusion.     The summer 
[DELstart] employed[DELend][ADDstart] engaged,[ADDend] heart 	 engaged, heart 
 season: 	 season; 
 yeild 	 yield 
 vintage. But 	 vintage: but 
[DELstart] hut[DELend][ADDstart] insensible[ADDend]  	 insensible 
 nature & 	 nature. And 
[DELstart] caused[DELend][ADDstart] ^[ADDend][ADDstart] made[ADDend]  	 made 
[DELstart] to[DELend] neglect 	 neglect 
 absent 	 absent, 
  	[NO 1823 VARIANT]
 that 	[NO 1823 VARIANT]
 them 	 them; 
 father. "I 	 father: “I 
 "you 	 you 
 yourself 	 yourself, 
[DELstart] thing[DELend]  	 will 
affection  "and 	 affection, and 
 "you. And you 	 you. You 
 "if 	 if 
[DELstart] you[DELend]  	[NO 1823 VARIANT]
 "in 	 in 
 corespondence, 	 correspondence 
 "that 	 that 
[DELstart] studies[DELend][ADDstart] duties[ADDend]  	 duties 
 neglected" 	 neglected.”     
[DELstart] rembered[DELend]  	[NO 1823 VARIANT]
his [DELstart] opinion[DELend]  	[NO 1823 VARIANT]
[ADDstart] his feelings[ADDend]  	 my father’s feelings; 
 occupation 	 employment, 
 itself 	 itself, 
a[DELstart] strong[DELend][ADDstart] n[ADDend]  	 an irresistible 
[DELstart] imagni[DELend]  	[NO 1823 VARIANT]
 wished 	 wished, 
 were 	 were, 
[DELstart] procr[DELend][ADDstart] ^[ADDend] all 	 procrastinate all 
 affection, untill 	 affection until 
object [DELstart] of my affection[DELend][DELstart] was[DELend] which 	 object, which 
 nature 	 nature, 
be I 	 be completed.     I 
[DELstart] in[DELend]  	[NO 1823 VARIANT]
 vice 	 vice, 
[DELstart] in the right[DELend][DELstart] in co conceive[DELend][ADDstart] ^[ADDend][ADDstart] he was[ADDend][ADDstart] X[ADDend][ADDstart] in co conceive[ADDend]  	[NO 1823 VARIANT]
in the  right 	 justified 
blame. . 	 blame. 
[DELstart] cl[DELend]  	[NO 1823 VARIANT]
 mind 	 mind, 
  	[NO 1823 VARIANT]
[ADDstart] ^[ADDend][ADDstart] a[ADDend]  	 a 
 any 	 an 
[DELstart] d[DELend]  	[NO 1823 VARIANT]
 affections 	 affections, 
 mix 	 mix, 
 unlawful 	 unlawful, 
[DELstart] it[DELend]  	[NO 1823 VARIANT]
say [DELstart] on that[DELend]  	 say, 
[DELstart] to[DELend]  	[NO 1823 VARIANT]
[DELstart] rul[DELend]  	[NO 1823 VARIANT]
[DELstart] was[DELend][ADDstart] were[ADDend] ways 	 were always 
 his 	 the 
 and 	 of 
 affections 	 affections, 
 never 	 not 
 enslaved, 	 enslaved; 
 country, 	 country; 
gradua[ADDstart] l[ADDend] ly, 	 gradually; 
 Empires 	 empires 
 & 	 and 
destroyed. But 	 destroyed.     But 
 interresting 	 interesting 
 My 	 proceed.     My 
[DELstart] an[DELend]  	[NO 1823 VARIANT]
 enquiring 	 inquiring into my occupations 
before what my [DELstart] co[DELend][DELstart] wer[DELend]  were. Winter spring 	 before. Winter, spring, 
[ADDstart] l[ADDend] abours 	 labours; 
 leaves – sights 	 leaves—sights 
 had alway yeilded 	 always yielded 
delight[DELstart] much[DELend][ADDstart] deeply[ADDend]  	 delight—so deeply 
[DELstart] taken up with[DELend] engrossed 	 engrossed 
  	[NO 1823 VARIANT]
 were 	 had 
 close. And 	 close; and 
 shewed 	 showed 
[DELstart] am[DELend]  anxiety 	 anxiety, 
 mines 	 mines, 
 unwholsome trade 	 unwholesome trade, 
 in 	 by 
[DELstart] nigh[DELend]  	[NO 1823 VARIANT]
fever oppressed  me 	 fever, 
[DELstart] nevous[DELend][ADDstart] ^[ADDend][ADDstart] nervous[ADDend]  	 nervous 
[DELstart] degre[DELend] most 	 most 
a [DELstart] fever[DELend]  	[NO 1823 VARIANT]
health &[DELstart] my nerves[DELend][DELstart] were fi[DELend]  	 health, and 
firm[ADDstart] ness[ADDend][ADDstart] ^[ADDend] of 	 firmness of 
[DELstart] driv[DELend]  	[NO 1823 VARIANT]
[DELstart] these[DELend][DELstart] p[DELend][ADDstart] such[ADDend] toms 	 such symptoms; 
[ADDstart] had t[ADDend]  	[NO 1823 VARIANT]
 It 	 I T  
 November 	 November, 
frame on whic  	 accomplishment of 
man comple[DELstart] And[DELend][ADDstart] te[ADDend][ADDstart] ,[ADDend] with 	 toils. With 
amount  ed 	 amounted 
 agony 	 agony, 
me [DELstart] and endeavour to[DELend] that 	 me, that 
might[ADDstart] i[ADDend] nfuse 	 might infuse 
thin[ADDstart] g[ADDend] that 	 thing that 
 morning, 	 morning; 
 window 	[NO 1823 VARIANT]
& my 	 and my 
 when 	 when, 
half extinguish ed light 	 half-extinguished light, 
 open.—It 	 open; it 
limbs.[DELstart] But how[DELend]  	 limbs.     
 emotion 	 emotions 
 catastrophe; 	 catastrophe, 
 form. 	 form? 
 proportion 	 proportion, 
[DELstart] h[DELend]  	[NO 1823 VARIANT]
[DELstart] handsome[DELend][DELstart] handsome[DELend][DELstart] Handsome[DELend][ADDstart] beautiful.[ADDend][ADDstart] Beautiful[ADDend] ; Great 	 beautiful. Beautiful!—Great 
[DELstart] dun[DELend]  	 yellow 
 of 	 was of 
black &  flowing 	 black, 
white  ness 	 whiteness; 
luxurianc[ADDstart] i[ADDend] es 	 luxuriances 
[DELstart] fomed[DELend] formed 	 formed 
 watry eyes 	 watery eyes, 
  	[NO 1823 VARIANT]
 complexion 	 complexion, 
 strait 	 straight 
lips. The 	 lips.     The 
 years 	 years, 
[DELstart] f[DELend]  	[NO 1823 VARIANT]
[DELstart] heath[DELend]  	[NO 1823 VARIANT]
exceed[ADDstart] ed[ADDend] moderation; 	 exceeded moderation; 
succeed ed these dreams vanished 	 finished, the beauty of the dream vanished, 
[ADDstart] ^[ADDend] to 	 to 
[DELstart] creature[DELend][ADDstart] being[ADDend]  	 being 
 room 	 room, 
[DELstart] remained[DELend][ADDstart] continued[ADDend]  	 continued 
 bed chamber 	 bed-chamber, 
 lenght 	 length 
 endured, 	 endured; 
 my 	 the 
 clothes 	 clothes, 
[DELstart] feew[DELend]  	[NO 1823 VARIANT]
 forgetfullness. 	 forgetfulness. 
 vain; 	 vain: 
 indeed 	 indeed, 
 dreams– 	 dreams. I thought 
Elizabeth [ADDstart] ^[ADDend] in 	 Elizabeth, in 
health  	 health, 
 Ingolstadt; delighted & surprised 	 Ingolstadt. Delighted and surprised, 
 her 	 her; 
 lips 	 lips, 
 lurid 	 livid 
  	[NO 1823 VARIANT]
 change 	 change, 
arms[ADDstart] :[ADDend][ADDstart] A[ADDend]  	 arms; a 
 envolepped 	 enveloped 
 form & 	 form, and 
 grave worms 	 grave-worms 
 flannel; 	 flannel. 
[ADDstart] ^[ADDend] from 	 from 
 horror, 	 horror; 
[DELstart] when I saw[DELend]  	[NO 1823 VARIANT]
 forehead 	 forehead, 
[DELstart] ah[DELend]  chattered 	 chattered, 
[DELstart] was[DELend][ADDstart] became[ADDend][ADDstart] s[ADDend] ed, 	 became convulsed; 
 moon 	 moon, 
 wretch — the 	 wretch—the 
created; he hel[ADDstart] d[ADDend] up 	 created. He held up the curtain of 
 curtain, 	 bed; 
eyes[ADDstart] —[ADDend] ; 	 eyes, 
called,[ADDstart] —[ADDend]  	 called, 
 me–His 	 me. His 
 opened 	 opened, 
[DELstart] in[DELend][ADDstart] in[ADDend]  	[NO 1823 VARIANT]
[DELstart] words[DELend] while 	 inarticulate sounds, while 
 spoken 	 spoken, 
 hear — 	 hear; 
[DELstart] had[DELend]  	[NO 1823 VARIANT]
 out 	 out, seemingly 
 me 	 me, 
 escaped 	 escaped, 
[DELstart] ran[DELend] rushed 	 rushed 
[DELstart] the[DELend][DELstart] case[DELend][ADDstart] the[ADDend][ADDstart] case[ADDend]  	 stairs. 
 a 	 the 
 night 	 night, 
 agitation; 	 agitation, 
 arrival 	 approach 
life. Oh! 	 life.     Oh! 
[ADDstart] ^[ADDend][ADDstart] again[ADDend]  	 again 
[DELstart] life[DELend][ADDstart] animation[ADDend]  	 animation 
  	[NO 1823 VARIANT]
 . 	 that wretch. 
[DELstart] and I thought[DELend]  	[NO 1823 VARIANT]
 then. But 	 then; but 
 endued with motion 	 rendered capable of motion, 
[DELstart] to[DELend]  	[NO 1823 VARIANT]
 never 	 not 
conceived. I 	 conceived.     I 
wretchedly–  sometimes 	 wretchedly. Sometimes 
pulse[ADDstart] s[ADDend]  	 pulse 
[ADDstart] ^[ADDend][ADDstart] r[ADDend] dly 	 hardly, 
 artery: At others 	 artery; at others, 
 sunk 	 sank 
[DELstart] with[DELend][ADDstart] thro[ADDend]  	 through 
[DELstart] Surely so wretched a[DELend] and mingled 	 Mingled 
hor ror 	 horror, 
[DELstart] disapp[DELend][DELstart] creature as I never before existed.[DELend] Dreams 	 disappointment; dreams 
 space 	 space, 
me– [DELstart] I[DELend]  	 me; 
complete. Morning — 	 complete!     Morning, 
 wet — 	 wet, 
leng[ADDstart] th[ADDend] dawned, 	 length dawned, 
[DELstart] to[DELend]  	[NO 1823 VARIANT]
Ingols stadt 	 Ingolstadt, 
&[DELstart] the[DELend][ADDstart] the its[ADDend]  clock 	 and clock, 
 pointed to 	 indicated 
sixth[DELstart] e[DELend]  	 sixth 
 court 	 court, 
 assylum 	 asylum, 
 steps 	 steps, 
[DELstart] ough[DELend]  	[NO 1823 VARIANT]
 in 	 of 
  	[NO 1823 VARIANT]
[DELstart] to[DELend]  	[NO 1823 VARIANT]
appartment [ADDstart] ^[ADDend][ADDstart] which[ADDend]  	 apartment which 
 inhabited 	 inhabited, 
 on 	 on, 
[DELstart] drizzling[DELend]  	[NO 1823 VARIANT]
sky. I 	 sky.     I 
 time endeavouring 	 time, endeavouring, 
 exercise 	 exercise, 
 streets 	 streets, 
 was 	 was, 
 doing: my 	 doing. My 
[DELstart] with[DELend][ADDstart] ^[ADDend] in 	 in 
 fear 	 fear; 
 steps 	 steps, 
me, "Like 	 me:             Like 
 who 	 who, 
lon[ADDstart] es[ADDend] "doth 	 lonely road,     Doth 
dread "and 	 dread,     And, 
round [DELstart] wal[DELend] And 	 round, walks on,     And 
head  "Because 	 head;     Because 
 "doth 	 fiend     Doth 
tread." Continueing 	 tread*.         *   Coleridge’s “Ancient Mariner.”           Continuing 
lenght [DELstart] opposite[DELend] opposite 	 length opposite 
 Inn 	 inn 
 paused 	 paused, 
 why 	 why; 
[ADDstart] ^[ADDend][ADDstart] it[ADDend]  	 it 
 nearer 	 nearer, 
 diligence; 	 diligence: 
 standing, and 	 standing; and, 
  	[NO 1823 VARIANT]
 doors 	 door 
 opened 	 opened, 
 who 	 who, 
  	[NO 1823 VARIANT]
 me 	 me, 
out. "My 	 out. “My 
 Frankenstien," 	 Frankenstein,” 
he  "How 	 he, “how 
 you; 	 you! 
 "fortunate 	 fortunate 
[ADDstart] ^[ADDend][ADDstart] very[ADDend]  	 very 
alighting." Nothing 	 alighting!”     Nothing 
[DELstart] see[DELend]  seing Clerval: 	 seeing Clerval; 
 Elizabeth 	 Elizabeth, 
 misfortune. 	 misfortune; 
felt[ADDstart] ^[ADDend] suddenly, 	 felt suddenly, 
[DELstart] for[DELend][ADDstart] during[ADDend] for 	 during 
 friend therefore 	 friend, therefore, 
manner & we 	 manner, and we 
 colledge. 	 college. 
[DELstart] ran on[DELend][DELstart] talked[DELend]  	[NO 1823 VARIANT]
mutual friends 	 mutual friends, 
[ADDstart] own[ADDend] good 	 own good 
 allowed 	 permitted 
Ingolstadt. "You 	 Ingolstadt. “You 
 believe," 	 easily believe,” 
[DELstart] "that[DELend] "it 	 “how great 
not with[DELstart] out[DELend] "trouble that I persuaded 	 the difficulty to persuade 
 "father 	 father 
 is 	 was 
 "necessary 	 necessary 
 "know nothing 	 understand any thing 
bookeeping "and indeed 	 book-keeping; and, indeed, 
 "incredulous 	 incredulous 
 last 	 last, 
applications  "was 	 unwearied entreaties was 
[ADDstart] ^[ADDend][ADDstart] that of[ADDend] "master 	 that of the Dutch schoolmaster 
Wakefield–   " I 	 Wakefield: ‘I 
florins– [DELstart] a year[DELend][DELstart] yr.[DELend][ADDstart] yr.[ADDend] "eat 	 florins a year without Greek, I eat 
 "But 	 without Greek.’ But 
 "length 	 length 
for  "learning, 	 of learning, 
[ADDstart] ^[ADDend][ADDstart] under[ADDend] take 	 to undertake 
discovery to 	 discovery to 
 "And 	 knowledge.”     “It gives me the greatest delight to see you; but tell me how you left 
brothers &Eliza he "only 	 brothers, and Elizabeth.”     “Very well, and very happy, only 
[DELstart] yo[DELend] "they 	 they 
seldom, & "by 	 seldom. By 
 bye, 	 by, 
 "a 	 a 
 "myself– But 	 myself.—But, 
 Frankenstein" 	 Frankenstein,” 
 he 	 he, 
 short & 	 short, and 
 "full 	 full 
 face "I 	 face, “I 
 "remark 	 remark 
 are. So 	 appear; so 
 "and 	 and 
 appear 	 look 
 "been 	 been 
nights." "You 	 nights.”     “You 
 right" 	 right; 
replied  "I 	[NO 1823 VARIANT]
[DELstart] several[DELend][DELstart] studious[DELend]  	[NO 1823 VARIANT]
occupation[DELstart] s[DELend]  	 occupation, 
[DELstart] did[DELend][ADDstart] have[ADDend][ADDstart] ed[ADDend][ADDstart] ^[ADDend][ADDstart] myself[ADDend]  	 have not allowed myself 
 rest 	 rest, 
[ADDstart] ;[ADDend]  	 see: 
 hope 	 hope, that 
those  "occupations 	 these employments 
 end—I 	 end, and that I 
free  "now 	 at length free.”     
hope." I 	[NO 1823 VARIANT]
 excessively: 	 excessively; 
 bear 	 endure 
of[ADDstart] ,[ADDend] & 	 of, and 
 occurences 	 occurrences 
prece[DELstart] e[DELend] ding 	 preceding 
[DELstart] I continued to walk[DELend][DELstart] theire[DELend]  	[NO 1823 VARIANT]
 therefore 	[NO 1823 VARIANT]
 colledge. 	 college. 
 reflected – 	 reflected, 
 shiver 	 shiver, 
 appartment 	 apartment 
 still there—alive 	 there, alive, 
 see him 	 behold this monster; 
 dreaded 	 feared 
[DELstart] h[DELend][DELstart] I therefore[DELend][ADDstart] ing[ADDend]  	 see him. Entreating 
[ADDstart] ^[ADDend][ADDstart] therefore[ADDend] to 	 therefore to 
[DELstart] while[DELend]  	[NO 1823 VARIANT]
recovered  myself, when 	 recollected myself. 
 paused 	 then paused; 
 open 	 forcibly open, 
 side. But 	 side; but 
  	 in: 
 appartment 	 apartment 
 empty, 	 empty; 
 bedroon 	 bed-room 
[DELstart] belief[DELend]  	[NO 1823 VARIANT]
 good fortune 	 good-fortune 
[DELstart] was[DELend][ADDstart] became[ADDend]  	 became 
 joy 	 joy, 
Henr We 	 Clerval.     We 
room & present  ly 	 room, and 
 breakfast: 	 breakfast; 
 me,–I 	 me; I 
 the 	[NO 1823 VARIANT]
 sensitiveness 	 sensitiveness, 
 place — 	 place; 
hand[ADDstart] s[ADDend] & 	 hands, and 
 arrival– 	 arrival; 
[DELstart] saw[DELend]  	[NO 1823 VARIANT]
[ADDstart] ^[ADDend][ADDstart] more attentively[ADDend] he 	 more attentively, he 
 account 	 account; 
 loud unrestrained 	 loud, unrestrained, 
laugh ter 	 laughter, 
him. My 	 him.     “My 
 Frankenstein," 	 Victor,” 
 he "What 	 he, “what, 
 God's sake 	 God’s sake, 
matter [DELstart] for[DELend]  do 	 matter? Do 
so – [DELstart] What has[DELend]  	 in that manner. 
this? Do 	 this?     “Do 
 me 	 me,” 
[DELstart] fef[DELend][ADDstart] s[ADDend]  	 hands 
[DELstart] Wh[DELend]  He 	 room; “ he  
 tell! Oh 	 tell.—Oh, 
 me 	 me! 
[DELstart] I[DELend]  me"– 	 me!” 
 me 	 me; 
furious  ly & 	 furiously, and 
fit. Poor 	 fit.     Poor 
 What 	 what 
 feelings. 	 feelings? 
[DELstart] joy[DELend][DELstart] meti[DELend]  meeting 	 meeting, 
 had 	[NO 1823 VARIANT]
 joy 	 joy, 
 did 	 was 
 grief 	 grief; 
[DELstart] senseless[DELend][ADDstart] lifeless[ADDend]  	 lifeless, 
[DELstart] several[DELend]  	[NO 1823 VARIANT]
  	[NO 1823 VARIANT]
 This 	 This 
 fever 	 fever, 
  	[NO 1823 VARIANT]
[DELstart] And[DELend]  during 	 During 
 this 	 that 
that [DELstart] kn[DELend]  	 that, 
 fathers 	 father’s 
 age 	 age, 
journey & wretched Elizabeth 	 journey, and how wretched my sickness 
 be 	 make Elizabeth, 
 had 	[NO 1823 VARIANT]
[ADDstart] ^[ADDend][ADDstart] grief[ADDend]  	 grief 
[DELstart] partly[DELend] ing 	 concealing 
 & 	 and 
 himself, and 	 himself; and, 
 had 	 felt 
 recovery 	 recovery, 
 that 	 that, 
 harm 	 harm, 
them. But 	 them.     But 
ill & surely 	 ill; and surely 
[DELstart] affection[DELend] & 	 and 
mo[ADDstart] ^[ADDend][ADDstart] n[ADDend] ster 	 monster 
 life 	 existence 
[ADDstart] my[ADDend] eyes, 	 my eyes, 
[DELstart] incessant[DELend]  	[NO 1823 VARIANT]
[ADDstart] Doubtless[ADDend] My 	 Doubtless my 
[DELstart] no[DELend][DELstart] doubt[DELend] surprised Henry – 	 surprised Henry: 
disordered  imagination 	 disturbed imagination; 
  	[NO 1823 VARIANT]
[DELstart] astonished him.[DELend][DELstart] sta[DELend]  	[NO 1823 VARIANT]
 & 	 and 
[DELstart] It was[DELend]  by 	 event.     By 
 degrees 	 degrees, 
 relapses 	 relapses, 
& grieved 	 and grieved 
friend [DELstart] that[DELend]  	 friend, 
 that 	[NO 1823 VARIANT]
 was 	 became 
 disappeared 	 disappeared, 
 trees. 	 trees that shaded my window. 
 spring & 	 spring; and 
 no doubt 	[NO 1823 VARIANT]
bosom[ADDstart] ,[ADDend]  	 bosom; 
 disappeared 	 disappeared, 
[DELstart] that consumed me[DELend][ADDstart] ,[ADDend] "how 	 passion.     “Dearest Clerval,” exclaimed I, “how kind, how 
 "whole winter 	 whole winter, 
spending it [DELstart] at[DELend]  	 being spent 
 study 	 study, 
 "has 	 has 
room:  "how 	 room. How 
 "the 	 the 
[DELstart] c[DELend] sion of– But 	 occasion; but 
me." "You 	 me.”     “You 
me," replied Henry,  "if 	 me entirely, if 
dis compose yourself; "but 	 discompose yourself, but 
ca[ADDstart] n[ADDend] "since 	 can; and since 
 "spirits 	 spirits, 
 "one subject; 	 one subject, 
not?" I trembled; one 	 not?”     I trembled. One 
 What 	 what 
to[ADDstart] ^[ADDend][ADDstart] an[ADDend]  	 to an 
think. Do not fright en yourself," 	 think?     “Compose yourself,” 
 colour," I 	 colour, “I 
 "it 	 it, 
 you. But 	 you; but 
 "and 	 and 
 so 	 very 
[DELstart] rec[DELend]  	[NO 1823 VARIANT]
 "your 	 your 
 hand – 	 hand-writing. 
 "ill 	 ill 
 "at 	 at 
silence." Is 	 silence.”     “Is 
"I said smiling  "My 	 my 
 Henry how 	 Henry. How 
 "that 	 that 
 thoughts 	 thought 
[DELstart] that[DELend][ADDstart] ߶[ADDend][ADDstart] those[ADDend]  	 fly towards those 
 "whom 	 whom 
 love 	 love, 
 "of 	 of 
love." "If 	 love.”     “If 
temper"  said Henry "you 	 temper, my friend, you 
perhaps  "to 	 to 
[DELstart] here[DELend]  	[NO 1823 VARIANT]
[DELstart] ly[DELend][DELstart] e[DELend]  	 lying 
 "cousin 	 cousin, 
believe."  	 believe.” 
[ADDstart] Ch V– 113[ADDend] He 	 C LERVAL  
 "To 	      “ To  
Frankenstien [DELstart] Apri[DELend][ADDstart] March[ADDend] "I 	 F RANKENSTEIN .       “ MY DEAR COUSIN ,     “I 
uneasi ness 	 uneasiness 
 disorder, 	 disorder: 
 handwriting 	 hand-writing; 
 Henry – Surely Victor 	 Henry. Surely, Victor, 
very ill and 	 exceedingly ill; and 
 wretched 	 wretched, 
 nearly 	 nearly 
 father 	 uncle 
[DELstart] of this[DELend] that 	 that 
[ADDstart] ߶[ADDend][ADDstart] undertaking[ADDend]  	 undertaking 
[DELstart] I[DELend][DELstart] but I entreated him not[DELend][DELstart] to undertake it[DELend][DELstart] because[DELend][DELstart] for[DELend][DELstart] although[DELend][DELstart] tha[DELend][DELstart] make him very ill[DELend][DELstart] and[DELend][ADDstart] to undertake it[ADDend][ADDstart] ^[ADDend][ADDstart] for[ADDend][ADDstart] n[ADDend][ADDstart] the[ADDend][ADDstart] have[ADDend] Clerval 	 Clerval 
 were 	 are 
better [DELstart] and[DELend][DELstart] arden[DELend][ADDstart] ^[ADDend]  	 better; I 
this[ADDstart] intelligence[ADDend]  	 this intelligence 
 handwriting 	 handwriting; 
 indeed Victor 	 Victor, 
[DELstart] uneasy[DELend][ADDstart] ^[ADDend] miserable 	 miserable 
 fear 	 fear, 
 world.– My uncles 	 world. Your father’s 
[DELstart] impro[DELend]  	[NO 1823 VARIANT]
[DELstart] well &[DELend][DELstart] far[DELend][ADDstart] far[ADDend]  vigorous 	 so vigorous, 
[DELstart] so[DELend][ADDstart] so[ADDend]  	[NO 1823 VARIANT]
 him; 	 him: 
sixteen  you know 	 sixteen, 
[DELstart] quite[DELend]  	[NO 1823 VARIANT]
  	[NO 1823 VARIANT]
 that 	 which 
 ago – 	 ago; 
well &[DELstart] y[DELend] "My 	 robust and active.     “My 
[DELstart] the[DELend] last night 	[NO 1823 VARIANT]
 Ernest 	 profession Ernest 
be should 	[NO 1823 VARIANT]
 ill health 	 illness 
 of 	 him of 
 habit 	 habits 
 application 	 application; 
health [DELstart] we[DELend]  	 health, 
air [DELstart] on[DELend] climbing 	 air, climbing 
 hills 	 hills, 
 I, therefore, 	 I therefore 
should[ADDstart] be[ADDend]  	 should be 
 farmer 	 farmer; 
 know cousin 	 know, cousin, 
 mine –A farmer's 	 mine. A farmer’s 
[DELstart] &[DELend]  	[NO 1823 VARIANT]
 hurtful 	 hurtful, 
 benificial 	 beneficial profession 
any[ADDstart] ^[ADDend] of 	[NO 1823 VARIANT]
[DELstart] father[DELend]  	[NO 1823 VARIANT]
being[ADDstart] ^[ADDend] educated 	 being educated 
interrest he 	 interest he 
 But 	 But, 
 fit 	 fitted 
[DELstart] better[DELend][DELstart] honourable[DELend][ADDstart] more honourable[ADDend][ADDstart] creditable[ADDend]  to 	 more creditable 
 man 	 man, 
[DELstart] it[DELend]  	[NO 1823 VARIANT]
[ADDstart] a[ADDend] nt & 	 confidant, and 
[DELstart] a helpmate[DELend][ADDstart] the accomplice[ADDend]  	 the accomplice, 
[DELstart] their[DELend][ADDstart] his[ADDend]  	 his 
employment[ADDstart] ^&[ADDend] And if he should become 	 profession of 
judge  	 lawyer. 
 said 	 said, 
[DELstart] rich[DELend] the occupation 	 the employments 
 farmer 	 farmer, 
 it 	 they 
honourable it was 	 honourable, they were 
employ  ment 	 species of occupation 
 nature 	 nature. 
 smiled 	 smiled, 
 said 	 said, 
[DELstart] ougt[DELend][ADDstart] g[ADDend]  	[NO 1823 VARIANT]
 myself; 	 myself, 
subject And 	 subject.     “And 
[DELstart] Ju[DELend]  	[NO 1823 VARIANT]
[DELstart] Martin[DELend] Perhaps 	 Moritz? Probably 
 not 	 not; 
therefore  tell you 	 relate 
 story 	 history, therefore, 
Mad.  Martin 	 Madame Moritz, 
 Mother 	 mother, 
 children 	 children, 
[DELstart] this[DELend]  	[NO 1823 VARIANT]
[DELstart] favou[DELend]  	[NO 1823 VARIANT]
father [DELstart] and[DELend][ADDstart] butthro[ADDend]  an odd perversity 	 father; but, through a strange perversity, 
Mother [DELstart] never[DELend]  	 mother 
[DELstart] bear[DELend][ADDstart] ^[ADDend] not 	 not 
 her and 	 her, and, 
[DELstart] Martin[DELend][ADDstart] Moritz[ADDend]  	 Moritz, 
 this, and 	 this; and, 
[DELstart] ten[DELend]  	[NO 1823 VARIANT]
old   	 of age, 
our house. The 	 her house. The 
[DELstart] state[DELend]  country, 	 country 
 & 	 and 
[DELstart] Ju Whilst[DELend] Hence 	 Hence 
dis[DELstart] s[DELend]  	 distinction 
into  & 	 of its inhabitants; and 
 despised 	 despised, their manners 
 & 	 and 
 at 	 in 
or England [DELstart] was[DELend] thus recieved into 	 and England. Justine, thus received in 
family to  learn 	 family, learned 
 servant, which 	 condition which, 
 country 	 country, 
sacri fize 	 sacrifice 
[DELstart] Where[DELend]  	 being.     “After what I have said, 
 that 	[NO 1823 VARIANT]
 now 	 well 
 all about it, 	 the heroine of my little tale: 
 yours, & 	 yours; and 
[DELstart] remember[DELend][ADDstart] recollect[ADDend]  	 recollect 
 said, 	 remarked, 
  	[NO 1823 VARIANT]
[DELstart] a[DELend]  	[NO 1823 VARIANT]
 humour 	 humour, 
 Justine, 	 Justine 
it [DELstart] from[DELend][ADDstart] for[ADDend]  	 it, for 
 gave 	 gives 
 Angelica:– she 	 Angelica—she 
 frank hearted 	 frank-hearted 
Aunt [DELstart] was very fond of her which[DELend][DELstart] caused[DELend] concieved an 	 aunt conceived a great 
[DELstart] her to[DELend][ADDstart] ^[ADDend][ADDstart] was[ADDend][ADDstart] induced[ADDend][ADDstart] ^[ADDend][ADDstart] to[ADDend]  	 was induced to 
an[DELstart] d[DELend]  	 an 
[ADDstart] ^[ADDend][ADDstart] had[ADDend]  	 had 
intended[DELstart] and she[DELend][ADDstart] .[ADDend] This 	 intended. This 
[DELstart] for[DELend]  	[NO 1823 VARIANT]
 world. 	 world: 
 professions–I 	 professions, I 
lips [DELstart] w[DELend]  	 lips; 
 eye 	 eyes 
 very 	 her disposition was 
 the greatest 	 thegreatest 
Aunt–  she 	 aunt. She 
[DELstart] miracle[DELend][ADDstart] model[ADDend]  	 model 
[DELstart] perfection[DELend][ADDstart] all[ADDend][ADDstart] excellence,[ADDend]  	 all excellence, 
 words 	 phraseology 
 even her 	[NO 1823 VARIANT]
[ADDstart] ^[ADDend][ADDstart] even[ADDend]  	 even 
[DELstart] very[DELend]  	[NO 1823 VARIANT]
[DELstart] puts[DELend][DELstart] in mind[DELend]  	 reminds me 
[DELstart] You did not[DELend] When 	    “When 
 Aunt died 	 aunt died, 
  	[NO 1823 VARIANT]
[DELstart] grif[DELend]  	[NO 1823 VARIANT]
 Justine 	 Justine, 
[DELstart] whole[DELend] illness 	 illness 
 greatest 	 most anxious 
 ill 	 ill; 
 tryals 	 trials 
her. One 	 her.     “One 
 one 	 one, 
 & 	 and 
 had died 	 died; 
 mother was now 	 mother, 
 daugher 	 daughter, 
troubled  and 	 troubled; 
judgement [ADDstart] sent[ADDend] from 	 judgment from 
[DELstart] punish[DELend][ADDstart] chastise[ADDend]  	 chastise 
partialli[ADDstart] t[ADDend] she 	 partiality. She 
 roman Catholic 	 Roman Catholic; 
 encouraged 	 confirmed 
idea[ADDstart] ^[ADDend] which 	 idea which 
concieved. . 	 conceived. 
 Months 	 months 
[DELstart] sh[DELend]  	[NO 1823 VARIANT]
 Mother. 	 mother. 
 girl 	 girl! 
 house 	 house; 
 aunt: 	 aunt; 
 manners 	 manners, 
[DELstart] did[DELend]  	[NO 1823 VARIANT]
 Mothers 	 mother’s 
[DELstart] fo[DELend] man 	 woman 
unkindness  	 unkindness, 
 oftenor 	 oftener 
 as 	 of 
[DELstart] h[DELend]  	[NO 1823 VARIANT]
 & 	 and 
 last 	 length 
 Mad. Martin 	 Madame Moritz 
 encreased 	 increased 
 rest 	 peace 
ever; [DELstart] for[DELend][DELstart] S[DELend][DELstart] did[DELend]  	 ever. She 
th[ADDstart] is[ADDend][ADDstart] ^[ADDend][ADDstart] last[ADDend] . 	 this last winter. 
 us 	 us; 
 extremely mild & pretty and 	 gentle, and extremely pretty; 
before [DELstart] she[DELend][DELstart] is[DELend]  	 before, 
[DELstart] air[DELend][ADDstart] mein[ADDend]  	 mien 
[DELstart] are[DELend]  	[NO 1823 VARIANT]
Aunt.[DELstart] And[DELend]  I 	 aunt.     “I 
 you also, My 	 you, my 
 Victor, 	 cousin, 
 him. He 	 him; he 
 age 	 age, 
eyes [DELstart] and[DELend]  	 eyes, 
 eyelashes 	 eye-lashes, 
 hair 	 hair. 
 smiles 	 smiles, 
 his cheeks 	 each cheek, 
health — his chin comes down in [DELstart] a[DELend] He 	 health. He 
 but 	 wives , but 
[DELstart] Caln[DELend]  	[NO 1823 VARIANT]
 favourite– 	 favourite, 
old [DELstart] Miss Mansfeld[DELend]  Now, 	 of age.     “Now, 
 Victor 	 Victor, 
  	[NO 1823 VARIANT]
[DELstart] I[DELend]  	[NO 1823 VARIANT]
 about your acquaintance. 	 concerning the good people of Geneva. 
 Mansfeld 	 Mansfield 
[DELstart] on[DELend][DELstart] her[DELend]  	[NO 1823 VARIANT]
[DELstart] Mebourne[DELend] bourne 	 Melbourne, 
 sister Manon 	 sister, Manon, 
 Hofland 	 Duvillard, 
 banker 	 banker, 
 schoolfellow 	 schoolfellow, 
Manoir [DELstart] ma[DELend]  	 Manoir, 
[DELstart] d[DELend]  	[NO 1823 VARIANT]
Geneva [DELstart] b[DELend]  	 Geneva. 
[DELstart] atready[DELend]  	[NO 1823 VARIANT]
 spirits 	 spirits, 
 he 	 is 
[DELstart] m[DELend]  	[NO 1823 VARIANT]
french  woman— Mad. Tavernier –She 	 Frenchwoman, Madame Tavernier. She 
 widow 	 widow, 
 Manoir 	 Manoir; 
[DELstart] adv[DELend]  admired 	 admired, 
body. I 	 body.     “I 
 Cousin 	 cousin; 
 can not 	 cannot 
 enquiring 	 inquiring 
 health— 	 health. 
 ill 	 ill, 
 yourself 	 yourself, 
 happy or— I 	 happy; or——I 
[ADDstart] ^[ADDend][ADDstart] on[ADDend]  	 of 
 question 	 question; 
flow[DELstart] dearrest[DELend]  – 	 flow. Adieu, my 
Victor  	 cousin.     “E LIZABETH  L AVENZA .   
  	[NO 1823 VARIANT]
 "Dear, 	 “Dear, 
 Elizabeth" 	 Elizabeth!” 
 letter"–I 	 letter, “I 
 instantly 	 instantly, 
 great pain 	 anxiety 
feel." I 	 feel.” I 
[DELstart] was[DELend] commenced 	 had commenced, 
[DELstart] went on[DELend][ADDstart] on[ADDend][ADDstart] proceeded[ADDend]  regularly–in 	 proceeded regularly. In 
  	[NO 1823 VARIANT]
 one 	 One 
[ADDstart] ^[ADDend][ADDstart] several[ADDend]  	 several 
 And in 	 In 
 this 	 this, 
under [DELstart] torments[DELend]  	 underwent 
usage [DELstart] that[DELend]  	 usage, 
[DELstart] befitten[DELend]  	[NO 1823 VARIANT]
[ADDstart] that[ADDend] my 	 that my 
 night – 	 night, 
labours & the 	 labours, and the 
misfortunes [DELstart] ([DELend]  	 misfortunes, 
[DELstart] Chemistry[DELend][ADDstart] Natural Philosophy[ADDend] . 	 natural philosophy. 
[ADDstart] a[ADDend] Chemical 	 a chemical 
[ADDstart] renewed[ADDend]  	 would renew 
[ADDstart] ^[ADDend] the 	 the 
my[ADDstart] ^[ADDend]  	[NO 1823 VARIANT]
symtoms. [DELstart] Lo[DELend] Henry 	 symptoms. Henry 
 this 	 this, 
[DELstart] packed up[DELend][ADDstart] removed[ADDend] all 	 removed all 
[DELstart] machines[DELend][DELstart] in a chest[DELend] apparatus 	 apparatus 
[DELstart] che[DELend]  he 	 view. He 
[DELstart] room[DELend][ADDstart] apartment,[ADDend]  	 apartment; 
 to 	 for 
 workshop. 	 laboratory. 
[DELstart] thrown away[DELend] made 	 made 
 even my excellent 	[NO 1823 VARIANT]
 praised 	 praised, 
[DELstart] the[DELend]  	[NO 1823 VARIANT]
 that 	[NO 1823 VARIANT]
dislike[DELstart] of[DELend][ADDstart] d[ADDend]  	 disliked 
 subject, 	 subject; 
 cause 	 cause, 
feelings[DELstart] on hearing myself praised[DELend][DELstart] he therefore[DELend]  	 feelings to modesty, and 
[DELstart] an[DELend]  	[NO 1823 VARIANT]
 desire 	 desire, 
 saw 	 saw, 
[DELstart] friend[DELend]  	[NO 1823 VARIANT]
[DELstart] K[DELend][DELstart] How cruel is[DELend]  	[NO 1823 VARIANT]
please [DELstart] and[DELend][DELstart] me[DELend] & 	 please, and 
[DELstart] tortured[DELend][DELstart] it was[DELend] I 	 tormented me. I 
[DELstart] had[DELend] carefully 	 had placed carefully, 
one [DELstart] placed[DELend]  	 one, 
[DELstart] dre[DELend]  	[NO 1823 VARIANT]
shew [DELstart] my[DELend]  	 exhibit 
 others 	 others, 
subject alledging [ADDstart] ^[ADDend][ADDstart] his[ADDend] ignorance & 	 subject, alleging, in excuse, his total ignorance; and 
 him 	 my friend 
 saw 	[NO 1823 VARIANT]
 me, 	 me; 
[DELstart] love[DELend]  	 affection 
[DELstart] pr[DELend]  	[NO 1823 VARIANT]
 thoughts, 	 recollection, 
  	[NO 1823 VARIANT]
 . 	 M. 
[DELstart] yet[DELend][ADDstart] ^[ADDend][ADDstart] equally[ADDend][ADDstart] &[ADDend] as 	 equally docile; and in 
illness had made me condition 	 condition at that time, 
in  	 insupportable sensitiveness, 
 econiums 	 encomiums 
[DELstart] that[DELend]  	[NO 1823 VARIANT]
Waldman —"Dam[ADDstart] n[ADDend] "the fellow," 	 Waldman. “D—n the fellow!” 
he "Why M "I tell 	 he; “why, M. Clerval, I assure 
[DELstart] beaut[DELend]  	[NO 1823 VARIANT]
 "us all– ay 	 us all. Ay, 
 please 	 please; 
 "it 	 it 
 nevertheless true – 	 nevertheeless true. 
 "who 	 who, 
[DELstart] two[DELend]  three 	 a few 
 ago 	 ago, 
[DELstart] to be[DELend][ADDstart] ^[ADDend] as 	 Cornelius Agrippa, as 
 gospel 	 gospel, 
 "now 	 now 
 "the university & 	 the university; and 
 "pulled down 	 pulled down, 
 "of countenance.—Aye, Aye, 	 of countenance.—Ay, ay,” 
 "he 	 he, 
[DELstart] countenance[DELend][ADDstart] ^[ADDend][ADDstart] face[ADDend] pressive 	 face expressive 
suffering "Mr. [DELstart] f[DELend] stein 	 suffering, “M. Frankenstein 
 modest 	 modest; 
 "a 	 a 
 man; 	 man. 
 "diffident 	 diffident 
 themselves 	 themselves, 
know M "Clerval; 	 know, M. Clerval; 
 young 	 young: 
 "one soon grows 	 that wears 
of that."  	 in a very short time.”     M. 
[DELstart] the subject of his own praise[DELend] an 	 an 
himself  and that 	 himself, which 
 the 	 a 
[DELstart] painful[DELend][ADDstart] agonizing[ADDend] Clerval 	 annoying to me.     Clerval 
  	[NO 1823 VARIANT]
 minutiæ 	 minutæ 
[DELstart] La[DELend] guages 	 Languages 
[DELstart] chief[DELend][ADDstart] ^[ADDend][ADDstart] principal[ADDend]  study for 	 principal study; and 
 wished 	 sought, by acquiring their elements, 
[DELstart] ^him[DELend][ADDstart] ^[ADDend][ADDstart] him[ADDend] tion 	 self-instruction 
– [DELstart] Greek[DELend][DELstart] &[DELend]  Arabic & Hebrew 	 to Geneva. Persian, Arabic, and Hebrew, 
atten[DELstart] when[DELend][ADDstart] Xso soon as X[ADDend]  	 attention, after 
 become 	 made himself 
 the 	[NO 1823 VARIANT]
& Latin langua ges. 	 and Latin. 
 part 	 part, 
 me 	 me; 
reflec tion 	 reflection, 
studies [DELstart] a[DELend]  	 studies, 
 found 	 felt 
 fellow pupil 	 fellow-pupil 
[DELstart] fr[DELend]  friend 	 friend, 
 I 	 found 
 a 	[NO 1823 VARIANT]
found [DELstart] instruct[DELend][ADDstart] not only[ADDend] tion 	 instruction 
[DELstart] There is something soothing[DELend] Their 	 Their 
 soothing 	 soothing, 
 before 	[NO 1823 VARIANT]
[DELstart] reading[DELend][DELstart] any[DELend][ADDstart] ^[ADDend][ADDstart] studying[ADDend][ADDstart] ^[ADDend] the 	 studying the 
of[ADDstart] any[ADDend]  	 of any 
[DELstart] books.[DELend][ADDstart] ^[ADDend][ADDstart] country.[ADDend] When 	 country. When 
read[DELstart] s[DELend]  	 read 
[DELstart] li[DELend]  writings 	 writings, 
 gardens 	 garden 
 roses – in 	 roses,—in 
&[DELstart] tears[DELend]  	 and frowns 
 enemy 	 enemy, 
 heart 	 heart. 
man[DELstart] warlike[DELend][ADDstart] ^[ADDend][ADDstart] l[ADDend] heroical 	 manly and heroical 
& Rome. Summer 	 and Rome.     Summer 
[DELstart] studies[DELend] & 	 occupations, and 
Autum[ADDstart] n[ADDend]  	 autumn; 
  	[NO 1823 VARIANT]
 accidents 	 accidents, 
 & 	 and 
[DELstart] and[DELend]  	[NO 1823 VARIANT]
 impassable 	 impassable, 
[DELstart] delayed[DELend][ADDstart] ^[ADDend][ADDstart] journey[ADDend]  untill 	 journey was retarded until 
[ADDstart] ^[ADDend][ADDstart] ensuing[ADDend]  	 ensuing 
bitterly [ADDstart] ^[ADDend][ADDstart] for[ADDend]  	 bitterly; for 
[ADDstart] t[ADDend] own 	 town, 
friends [DELstart] and[DELend]  my 	 friends. My 
 town 	 place, 
winter [ADDstart] ^[ADDend][ADDstart] however[ADDend]  	 winter, however, 
[DELstart] however[DELend][DELstart] a[DELend][DELstart] one[DELend][ADDstart]  spent[ADDend][ADDstart] ly[ADDend]  	 spent cheerfully; 
 late 	 late, 
[DELstart] Ma[DELend]  	    
 was 	 had 
[DELstart] finis[DELend][DELstart] end[DELend] pleated, 	 commenced, 
 daily 	[NO 1823 VARIANT]
 that 	 daily which 
[DELstart] return[DELend][ADDstart] ^[ADDend][ADDstart] departure,[ADDend]  When 	 departure, when 
 Ingolstadt 	 Ingolstadt, 
in habited.– 	 inhabited. 
 acceeded 	 acceded 
propos[ADDstart] ^[ADDend][ADDstart] ition[ADDend] – 	 proposition: 
 Exercise 	 exercise, 
[ADDstart] ^[ADDend][ADDstart] the[ADDend]  	 the 
coun  	 country. 
 try. 	[NO 1823 VARIANT]
 perambulations. My 	 perambulations: my 
 restored 	 restored, 
 vigour 	 strength 
air[DELstart] ,X[DELend][ADDstart] X[ADDend]  	 air 
 the 	 the 
progress  	 progress, 
 rendered 	 secluded 
unsocia[DELstart] ble[DELend][ADDstart] l,[ADDend][ADDstart] had[ADDend]  shunned 	 from 
[DELstart] face[DELend] company 	 intercourse 
 fellow beings But 	 fellow-creatures, and rendered me unsocial; but 
 heart. 	 heart; 
 nature 	 nature, 
 Friend! How 	 friend! how 
 me 	 me, 
 mind untill 	 mind, until 
persuit[DELstart] e[DELend]  	 pursuit 
[ADDstart] ^[ADDend][ADDstart] me[ADDend]  untill 	 me, until 
gentle  ness & 	 gentleness and 
 & 	 and 
[ADDstart] ^[ADDend][ADDstart] my senses[ADDend]  	 my senses; 
[DELstart] now[DELend][ADDstart] ^[ADDend][ADDstart] now[ADDend]  	[NO 1823 VARIANT]
 who 	 who, 
 & 	 and 
care – [DELstart] I[DELend][DELstart] and[DELend][DELstart] in[DELend]  	 care. When happy, 
 had 	 had 
bes[DELstart] bo[DELend] towing 	 bestowing 
  — 	 sensations. 
[DELstart] filled[DELend]  	[NO 1823 VARIANT]
verdant[DELstart] s[DELend]  	 verdant 
extasy.–[ADDstart] T[ADDend][ADDstart] ^[ADDend][ADDstart] present[ADDend]  	 ecstasy. The present 
 divine – 	 divine; 
[DELstart] blossomed[DELend][ADDstart] ^[ADDend][ADDstart] bloomed[ADDend]  	 bloomed 
 hedges 	 hedges, 
 bud– 	 bud: 
[DELstart] dis[DELend]  	[NO 1823 VARIANT]
 not disturbed 	 undisturbed 
 that 	 which 
 preceeding 	 preceding 
me not withstand ing 	 me, notwithstanding 
off with 	 off, with 
burthen.[DELstart] a[DELend]  	 burden.     Henry 
[DELstart] im[DELend]  	[NO 1823 VARIANT]
 gaiety 	 gaiety, 
[DELstart] joy[DELend][ADDstart] feelings[ADDend]  – 	 feelings: 
exer ted 	 exerted 
 feelings 	 sensations 
[DELstart] al[DELend]  	[NO 1823 VARIANT]
[DELstart] mind[DELend][ADDstart] ^[ADDend][ADDstart] soul[ADDend] . 	 soul. 
astonishing.  his 	 astonishing: his 
 imagination 	 imagination; 
persi an& 	 Persian and 
[DELstart] great[DELend][ADDstart] ^[ADDend][ADDstart] wonderful[ADDend]  	 wonderful 
 interrest. 	 passion. 
 poems 	 poems, 
 arguments 	 arguments, 
ingenuity. We 	 ingenuity.     We 
[ADDstart] ^[ADDend] to 	 to 
colledge  	 college 
 sunday – 	 Sunday afternoon: 
pea  sants 	 peasants 
 dancing 	 dancing, 
 joyful 	 gay 
 happy – my 	 happy. My 
 high 	 high, 
[DELstart] a[DELend]  	[NO 1823 VARIANT]
[DELstart] hilarity[DELend]  	 unbridled 
  	[NO 1823 VARIANT]
 On 	 O N , 
 return 	 return, 
father.  You 	 father:—      ”To  V. F RANKENSTEIN .     “ MY DEAR VICTOR,      “You 
impati[DELstart] the[DELend]  	 impatiently 
[DELstart] the[DELend][ADDstart] a[ADDend]  	 a 
[DELstart] which was[DELend]  	[NO 1823 VARIANT]
lines [DELstart] only[DELend][DELstart] to[DELend][DELstart] fix[DELend][DELstart] that[DELend] merely 	 lines, merely 
day[DELstart] date[DELend] on 	 day on 
you  – but 	 you. But 
[DELstart] very[DELend][ADDstart] ^[ADDend][ADDstart] a[ADDend]  	 a 
[ADDstart] ^[ADDend][ADDstart] kindness[ADDend] and 	 kindness, and 
[ADDstart] ^[ADDend][ADDstart] be[ADDend]  	 be 
[DELstart] be[DELend] , 	 surprise, 
son[DELstart] e[DELend] , 	 son, 
 your 	 you 
 welcome 	 welcome, 
[DELstart] heho[DELend][ADDstart] e[ADDend] ld 	 behold, 
 contrary 	 contrary, 
wretched ness. 	 wretchedness? 
 absence 	 Absence 
 griefs 	 griefs; 
 can 	 shall 
 child.? 	 child? 
woeful  news 	 woful news, 
 page 	 page, 
tidings. William 	 tidings.     “William 
 dead! That 	 dead!—that 
 child 	 child, 
 & 	 and 
 me 	 my heart, 
 gentle 	 gentle, 
 gay, 	 gay! 
Murdered! I 	 murdered!     “I 
[DELstart] o[DELend]  	[NO 1823 VARIANT]
 you 	 you; 
  	[NO 1823 VARIANT]
 Last thurday 	 “Last Thursday 
[DELstart] 26[DELend][DELstart] yourmy[DELend][DELstart] cousin[DELend][ADDstart] my[ADDend] my niece 	 7th) I, my niece, 
 brothers 	 brothers, 
[DELstart] fat[DELend]  	[NO 1823 VARIANT]
[DELstart] ale[DELend]  	[NO 1823 VARIANT]
[DELstart] When[DELend] and 	 returning; and 
[DELstart] found[DELend][ADDstart] ^[ADDend][ADDstart] discovered[ADDend]  	 discovered 
 Ernest 	 William 
 William 	 Ernest, 
 untill 	 until 
came [DELstart] up[DELend] enquired for 	 came, and inquired if we had seen 
 brother 	 brother; 
 said 	 said, 
 he 	 they 
with [DELstart] them[DELend] and 	 together, 
 himself 	 himself, 
had [DELstart] wai[DELend][DELstart] fo[DELend][ADDstart] vainly[ADDend]  	 vainly sought 
 him & 	 him, and 
wai  ted 	 waited for him 
 time 	 time, 
return. This 	 return.     “This account 
 us 	 us, 
[DELstart] sought[DELend] continued 	 continued 
him untill 	 him until 
fell[DELstart] l[DELend] ; 	 fell, 
house: [DELstart] but[DELend]  he 	 house. He 
 there – 	 there. 
 again 	 again, 
 torches 	 torches; 
 rest 	 rest, 
 child 	 boy 
 & 	 and 
[DELstart] We found him[DELend][DELstart] four[DELend][ADDstart] A[ADDend] in 	 About five in 
 boy 	 boy, 
  	[NO 1823 VARIANT]
 & 	 and 
health stretch  ed 	 health, stretched 
 motionless– 	 motionless: 
 murderers 	 murderer’s 
neck. He 	 neck.     “He 
 home 	 home, 
[DELstart] extreme[DELend][DELstart] wh[DELend][DELstart] misery[DELend][DELstart] agony[DELend][ADDstart] anguish[ADDend]  	 anguish 
 revealed 	 betrayed 
  	 very 
[DELstart] which[DELend][DELstart] refused[DELend][ADDstart] ^[ADDend] At 	 At 
her  	 her; 
[DELstart] [DELend]  	[NO 1823 VARIANT]
lay [DELstart] quickly[DELend]  	 lay, 
 victim 	 victim, 
[DELstart] hads[DELend][DELstart] Go[DELend]  Oh 	 hands exclaimed, ‘O 
[DELstart] this sweet[DELend][DELstart] babe[DELend][DELstart] .[DELend]  	[NO 1823 VARIANT]
 She fainted 	 infant!’     “She fainted, 
 retored 	 restored 
difficulty; [DELstart] and[DELend]  when 	 difficulty. When 
 lived 	 lived, 
 sigh– 	 sigh. 
 me 	 me, 
[DELstart] we[DELend][DELstart] we[DELend]  	[NO 1823 VARIANT]
 Mother. 	 mother. 
 gone 	 gone, 
[DELstart] of[DELend][DELstart] Come my dear Victor[DELend][DELstart] him[DELend]  	 of him 
[DELstart] but[DELend][ADDstart] altho[ADDend]  	 present, although 
[DELstart] are[DELend] to 	 to 
him are 	 him are 
William. Come, 	 William.     “Come, 
 Victor, 	 Victor; 
  	[NO 1823 VARIANT]
Elizabeth, [DELstart] who[DELend][ADDstart] She[ADDend]  	 Elizabeth. She 
[ADDstart] ^[ADDend][ADDstart] continually[ADDend] & 	 continually, and 
[DELstart] of all how u[DELend][DELstart] so[DELend]  	[NO 1823 VARIANT]
[DELstart] and[DELend][DELstart] of th[DELend][ADDstart] ^[ADDend]  	[NO 1823 VARIANT]
death— pierce 	 death; her words pierce 
 unhappy 	 unhappy; 
[DELstart] that[DELend]  	[NO 1823 VARIANT]
[DELstart] co[DELend]  	[NO 1823 VARIANT]
[DELstart] come[DELend][ADDstart] return[ADDend] and 	 return and 
 comforter. 	 comforter? 
 Mother! 	 mother! 
 say 	 say, 
[DELstart] this grief[DELend][DELstart] –[DELend][ADDstart] t[ADDend] he cruel 	 the cruel, 
darling. Come, 	 darling!     “Come, 
[DELstart] w[DELend]  	[NO 1823 VARIANT]
 assassin 	 assassin, 
 gentleness 	 gentleness, 
 heal 	 heal, 
 festering 	 festering, 
[DELstart] woul[DELend]  	[NO 1823 VARIANT]
[DELstart] soul[DELend]  	[NO 1823 VARIANT]
 son & friend 	 friend, 
 you & 	 you, and 
 Your 	    “Your 
 & 	 and 
father [DELstart] Al[DELend] Clerval 	 father,     A LPHONSE  F RANKENSTEIN .     “Geneva, May 12th, 17—.”     Clerval, 
 letter 	 letter, 
in observ-  ing 	 to observe 
 table 	 table, 
hands. "My 	 hands.     “My 
 Frankenstien," 	 Frankenstein,” 
[DELstart] hen[DELend]  Henry 	 Henry, 
 saw 	 perceived 
 bitterness "are 	 bitterness, “are 
 "my 	 My 
happened?" I 	 happened?”     I 
[DELstart] read[DELend] take 	 take 
 letter 	 letter, 
 & 	 and 
 most extreme 	 extremest 
[DELstart] and[DELend]  tears 	 Tears 
[DELstart] gush[DELend][ADDstart] ^[ADDend][ADDstart] also[ADDend]  	 gushed 
[DELstart] his[DELend][ADDstart] ^[ADDend][ADDstart] the[ADDend]  	 the 
 of Clerval 	 of Clerval, 
  –"I 	 misfortune.     “I 
 "no 	 no 
 friend," 	 friend,” 
he [DELstart] my[DELend][DELstart] misfortune[DELend][ADDstart] disaster[ADDend]  	 he; “your disaster 
irreperable.[DELstart] "[DELend]  	 irreparable. 
 "do 	 do 
do"? "To 	 do?”     “To 
Geneva[DELstart] "[DELend]  	 Geneva: 
 Clerval, 	 Henry, 
horses" During 	 horses.”     During 
walk [DELstart] C[DELend] oured 	 walk, Clerval endeavoured 
 spirits– 	 spirits. 
 the 	[NO 1823 VARIANT]
[DELstart] conversatio[DELend][DELstart] t[DELend]  	 consolation, but 
shew[ADDstart] i[ADDend] ng 	 exhibiting 
 "Poor William" 	 “Poor William!” 
 "that 	 he, “that 
 "child 	 child; 
 "mother. 	 mother. 
 weep 	 weep, 
 "he 	 he 
 rest 	 rest: 
 "murderers grasp – 	 murderer’s grasp; 
[DELstart] green[DELend]  	[NO 1823 VARIANT]
 "gentle form 	 gentle form, 
pain–He  "can 	 pain. He can 
pity his  "survivors 	 pity; the survivors 
 sufferers 	 sufferers, 
 "for 	 for 
the[DELstart] ir[DELend]  	 the 
 "Those 	 Those 
 stoics 	 Stoics, 
 "was 	 was 
 evil 	 evil, 
 "ought 	 ought 
[DELstart] that[DELend]  	[NO 1823 VARIANT]
 "on 	 on 
 "object 	 object, 
urged – even  "Cato 	 urged. Even Cato 
  	 brother.” 
 this 	 thus 
huried [DELstart] thou[DELend]  	 hurried 
 streets 	 streets; 
[DELstart] memor[DELend] mind 	 mind, 
 afterwads 	 afterwards 
[DELstart] As soon[DELend]  	[NO 1823 VARIANT]
 arrived 	 arrived, 
 Cabriolet 	 cabriole, 
[DELstart] left Ingo[DELend] well 	 bade farewell 
friend. My 	 friend.     My 
 on 	 on, 
 & 	 and 
[ADDstart] with[ADDend] my 	 with my 
 friends 	 friends; 
[DELstart] t[DELend]  	[NO 1823 VARIANT]
 town 	 town, 
sla[ADDstart] ^[ADDend][ADDstart] c[ADDend] kened 	 slackened 
[DELstart] pace[DELend][DELstart] I[DELend][DELstart] C[DELend][ADDstart] progress[ADDend]  	 progress. 
[DELstart] crowed[DELend]  	[NO 1823 VARIANT]
[DELstart] scee[DELend]  	 through 
 youth 	 youth, 
 five years, how 	 six years. How 
[DELstart] during[DELend][ADDstart] since[ADDend][ADDstart] ?[ADDend]  one great 	 during that time! One 
 place 	 place; 
 circumstance 	 circumstances 
[DELstart] sapped[DELend][DELstart] worked[DELend][ADDstart] worked[ADDend]  	[NO 1823 VARIANT]
[DELstart] degreed[DELend]  	[NO 1823 VARIANT]
[DELstart] worked[DELend][DELstart] t[DELend][DELstart] as great[DELend][ADDstart] worked other[ADDend][ADDstart] ^[ADDend][ADDstart] which[ADDend]  	 worked other alterations, which, 
 it might be 	 they were 
 tranquilly would 	 tranquilly, might 
 me 	 me; 
[DELstart] had[DELend][DELstart] N[DELend]  	[NO 1823 VARIANT]
advance [DELstart] fea[DELend]  	 advance, 
[DELstart] thoug[DELend]  	[NO 1823 VARIANT]
tremble [DELstart] while[DELend][ADDstart] although[ADDend]  	 tremble, although 
[DELstart] could not[DELend] was 	 was 
  	 to define them. 
 I 	 I 
[DELstart] thus[DELend]  	 two days 
Lausanne for  two days not daring to proceed. 	 Lausanne, in this painful state of mind. 
 lake – 	 lake: 
 placid – 	 placid; 
 calm 	 calm, 
 Snowy mountains the "Palaces 	 snowy mountains, “the palaces 
Nature"[DELstart] Lord Byron[DELend][ADDstart] XXLord Byron[ADDend] were 	 nature,” were 
 degrees, this 	 degrees the 
[DELstart] proceeded[DELend] continued 	 continued 
 lake 	 lake, 
 town – 	 town. 
 Jura; 	 Jura, 
[ADDstart] ^[ADDend][ADDstart] bright[ADDend] summit 	 bright summit 
 Mount Blanc– 	 Mont Blanc; 
 child– Dear mountains 	 child: “Dear mountains! 
 lake 	 lake! 
 wanderer 	 wanderer? 
 clear 	 clear; 
 is 	 and placid. Is 
[ADDstart] ^[ADDend][ADDstart] to[ADDend] prognosticate peace 	 to prognosticate peace, 
mock[ADDstart] at[ADDend]  	 mock at 
unhappiness? I 	 unhappiness?”     I 
friend [ADDstart] ^[ADDend] that 	 friend, that 
 circumstances 	 circumstances; 
 happiness 	 happiness, 
[DELstart] dwell[DELend][ADDstart] ^[ADDend][ADDstart] think[ADDend][ADDstart] f[ADDend]  	 think of 
 pleasure – 	 pleasure. 
 Country 	 country, 
country Who [ADDstart] ^[ADDend] but 	 country! who but 
native can 	 native can 
[ADDstart] ^[ADDend][ADDstart] r[ADDend] eams 	 streams, 
 mountains and 	 mountains, and, 
 all 	 all, 
lake [DELstart] and[DELend]  	 lake. 
 Yet 	 Yet, 
 home 	 home, 
 me – night 	 me. Night 
[DELstart] me[DELend]  	 around; 
 mountains 	 mountains, 
gloomily I pictured [DELstart] to mysel[DELend][DELstart] f[DELend] evil 	 gloomily. The picture appeared a vast and dim scene of evil, 
 persuaded myself 	 I foresaw obscurely 
[DELstart] the[DELend][DELstart] most[DELend]  	[NO 1823 VARIANT]
w[DELstart] h[DELend] retched 	 wretched 
 beings– 	 beings. 
[DELstart] prho[DELend]  	[NO 1823 VARIANT]
 truly 	 truly, 
only in 	 only in 
circumstance:  	 circumstance, 
[DELstart] of[DELend]  	[NO 1823 VARIANT]
[DELstart] feel[DELend][DELstart] .[DELend]  	[NO 1823 VARIANT]
  	[NO 1823 VARIANT]
[ADDstart] ^[ADDend][ADDstart] in[ADDend]  	 It was completely dark 
[DELstart] and[DELend] the 	 in the environs of Geneva; the 
 Geneva 	 the town 
[DELstart] closed[DELend][ADDstart] ^[ADDend][ADDstart] shut[ADDend]  	 shut; 
 determined 	 was obliged 
 remain that 	 pass the 
 Secheron 	 Secheron, 
 -ward 	[NO 1823 VARIANT]
[DELstart] night[DELend][ADDstart] sky[ADDend]  	 sky 
[DELstart] very fine[DELend][DELstart] unable[DELend][ADDstart] serene[ADDend]  	 serene; and, 
 rest 	 rest, 
[DELstart] walk toward[DELend][ADDstart] visit[ADDend]  	 visit 
m[ADDstart] y[ADDend] poor 	 my poor 
murdered;  as 	 murdered. As 
 walked 	 could not pass through the town, 
 perceived 	 was obliged to cross the lake in 
storm collecting  on the other side of the lake. 	 boat to arrive at Plainpalais. During this short voyage 
 play 	 playing on the summit of Mont Blanc 
 figures and gained 	 figures. The storm appeared to approach rapidly; and, on landing, I ascended 
 summit 	 low hill, 
[DELstart] the[DELend][ADDstart] ^[ADDend][ADDstart] its[ADDend]  	 its 
advanced [DELstart] slowly and[DELend]  	 advanced; the heavens were clouded, 
 drops 	 drops, 
encreased. I 	 increased.     I 
 seat 	 seat, 
 walk 	 walked 
aug mented 	 increased 
 minute 	 minute, 
[DELstart] violently over[DELend]  	[NO 1823 VARIANT]
head —   	 head. 
Salêve [ADDstart] ^[ADDend][ADDstart] the Jura[ADDend]  	 Salêve, the Juras, 
 Savoy— 	 Savoy; 
[DELstart] and[DELend]  	[NO 1823 VARIANT]
lake; [DELstart] and[DELend] then 	 lake, making it appear like a vast sheet of fire; then 
[DELstart] black[DELend][DELstart] til[DELend][ADDstart] ^[ADDend][ADDstart] darkness[ADDend]  untill 	 darkness, until 
[ADDstart] ^[ADDend][ADDstart] preceeding[ADDend]  	 preceding 
[DELstart] A[DELend]  	[NO 1823 VARIANT]
 storm 	 storm, 
[DELstart] that country[DELend][ADDstart] Switzerland[ADDend]  	 Switzerland, 
[DELstart] was[DELend][ADDstart] hung[ADDend]  	 hung 
[DELstart] noth[DELend]  	[NO 1823 VARIANT]
town [DELstart] and at[DELend][ADDstart] over[ADDend]  	 town, over 
[DELstart] where[DELend] of 	 of 
[DELstart] turns[DELend][ADDstart] ^[ADDend] which 	 which 
between the 	 between the 
[DELstart] changing[DELend][ADDstart] the[ADDend] village 	 the village 
Copet[ADDstart] u[ADDend][ADDstart] s[ADDend]  — another 	 Copêt. Another 
 flashes 	 flashes; 
[DELstart] appeared[DELend]  	[NO 1823 VARIANT]
 the Mole – 	[NO 1823 VARIANT]
name of a 	 Môle, a 
lake. While 	 lake.     While 
 storm – 	 storm, 
 terrific 	 terrific, 
[DELstart] listlessly[DELend] on 	 on 
step – [DELstart] I felt that[DELend][ADDstart] e[ADDend]  	 step. This 
hands & ex  claimed aloud "William, 	 hands, and exclaimed aloud, “William, 
 angel, 	 angel! 
 dirge!"– 	 dirge!” 
words [DELstart] a flash of lightning[DELend] I 	 words, I 
gloom[DELstart] discovered to me[DELend]  	 gloom 
me –  I 	 me; I 
 fixed 	 fixed, 
 intently, 	 intently: 
mista ken a 	 mistaken. A 
 illumined 	 illuminated 
object and 	 object, and 
to me  	 its shape plainly to me; 
gigantc sta[DELstart] n[DELend][DELstart] , its[DELend] & 	 gigantic stature, and 
aspect more 	 aspect, more 
tha[DELstart] man could be[DELend][ADDstart] n[ADDend] belongs 	 than belongs 
humanity[DELstart] explain[DELend]  	 humanity, 
 who 	 that 
[ADDstart] t[ADDend]  	[NO 1823 VARIANT]
conception  	 conception) 
 brother. 	 brother? 
 imagination 	 imagination, 
[ADDstart] ^[ADDend] of 	 of 
truth  — 	 truth; 
 chattered 	 chattered, 
[DELstart] th[DELend]  	[NO 1823 VARIANT]
 support — 	 support. 
 quickly 	[NO 1823 VARIANT]
[DELstart] And[DELend][DELstart] I^could not doubted[DELend][DELstart] not[DELend][DELstart] my[DELend][DELstart] the[DELend][DELstart] thought[DELend][DELstart] was agony^I was agonized by the bare probability[DELend][ADDstart] H[ADDend][ADDstart] ^[ADDend][ADDstart] could not[ADDend][ADDstart] ^[ADDend][ADDstart] I was agonized by the bare probability[ADDend][ADDstart] in[ADDend]  	 Nothing in 
 was 	 He  was 
ir proof 	 irresistible proof 
  — 	 fact. 
pur sueing 	 pursuing 
 devil, 	 devil; 
[ADDstart] ^[ADDend]  	[NO 1823 VARIANT]
 vain 	 vain, 
 hanging 	 hanging 
 Mont-Salêve; he 	 south. He 
 summit 	 summit, 
dissap[ADDstart] e[ADDend] I 	 disappeared.     I 
 motionless the 	 motionless. The 
 ceased 	 ceased; 
continued & the 	 continued, and the 
 inveloped 	 enveloped 
a[DELstart] pitchy[DELend][ADDstart] n[ADDend][ADDstart] ^[ADDend][ADDstart] impenetrable[ADDend] ness. I revolved in my mind 	 an impenetrable darkness. 
in  I resolved 	[NO 1823 VARIANT]
[DELstart] u[DELend] untill now, 	 had until now 
forget.  The 	 forget: the 
my [DELstart] [DELend]  The 	 the creation; the 
creature the 	[NO 1823 VARIANT]
 hands, 	 hands 
side – [ADDstart] &[ADDend]  	 side; 
[DELstart] Its[DELend][DELstart] It was now nearly[DELend]  two 	 Two 
[ADDstart] ^[ADDend] had 	 had 
[DELstart] of[DELend]  	[NO 1823 VARIANT]
 life, 	 life; 
crime – [DELstart] ?[DELend] Alas! 	 crime? Alas! 
[ADDstart] ^[ADDend]  	 had 
 in 	 into 
 wretch 	 wretch, 
[DELstart] deat[DELend][DELstart] For[DELend][ADDstart] for[ADDend]  	 carnage and misery; 
brother? No 	 brother?     No 
 of 	[NO 1823 VARIANT]
 night 	 night, 
spent[ADDstart] ^[ADDend][ADDstart] cold & wet[ADDend]  	 spent, cold and wet, 
[DELstart] cold and wet[DELend] . 	[NO 1823 VARIANT]
th[ADDstart] e[ADDend][ADDstart] ^[ADDend] incovenience 	 the inconvenience 
weather.  	 weather; 
 in 	[NO 1823 VARIANT]
[DELstart] scene[DELend]  	[NO 1823 VARIANT]
 despair 	 despair. 
[DELstart] wretch[DELend][ADDstart] being[ADDend]  	 being 
 in 	[NO 1823 VARIANT]
mankind [DELstart] for pu[DELend] and 	 mankind, and 
& the 	 and 
effect purposes 	 effect purposes 
[DELstart] mischief[DELend] horror 	 horror, 
[DELstart] this[DELend]  	[NO 1823 VARIANT]
had now 	 had now 
[DELstart] ow[DELend]  vampire; 	 own vampire, 
 grave 	 grave, 
 who were 	 that was 
me. Day dawned 	 me.     Day dawned; 
 town – the 	 town. The 
 open 	 open, 
father's [DELstart] s[DELend][DELstart] n[DELend]  	 father’s house. My 
murderer & cause 	 murderer, and cause 
[DELstart] search[DELend]  	[NO 1823 VARIANT]
 what 	 on 
 was 	[NO 1823 VARIANT]
[DELstart] creature[DELend][ADDstart] being[ADDend]  	 being 
 created 	 formed, 
mountain[DELstart] story[DELend]  was utterly improbable 	 mountain. I remembered also the nervous fever with which I had been seized just at the time that I dated my creation, 
 well 	[NO 1823 VARIANT]
[DELstart] related[DELend][ADDstart] communicated[ADDend]  	 communicated 
[DELstart] tale[DELend][ADDstart] ^[ADDend][ADDstart] relation[ADDend]  	 relation 
 me 	 me, 
delirium  Besides 	 insanity. Besides, 
the  elude 	[NO 1823 VARIANT]
far[DELstart] believed[DELend][DELstart] which was[DELend][DELstart] utterly impossible[DELend][ADDstart] ^[ADDend] as 	 far credited as 
[DELstart] its[DELend][DELstart] self[DELend][ADDstart] my[ADDend]  	 my 
it[DELstart] the com[DELend] Besides 	 it. Besides, 
 a 	 arrest a 
[DELstart] that could[DELend] capable 	 capable 
[DELstart] steep[DELend][ADDstart] overhanging[ADDend]  	 overhanging 
 Mont-Salêve? 	 Mount Salêve? 
[ADDstart] ^[ADDend][ADDstart] remain[ADDend] It 	 remain silent.     It 
 fathers 	 father’s 
servant[ADDstart] s[ADDend] not 	 servants not 
 time 	 hour 
 Five 	    Six 
 elapsed–passed 	 elapsed, passed 
  	[NO 1823 VARIANT]
 a 	 the 
 mother 	 mother, 
 mantlepiece. 	 mantelpiece. 
 piece 	 subject, 
 to please 	 at 
 father 	 father’s desire, 
 Beaumont 	 Beaufort 
 despair 	 despair, 
rustic[ADDstart] ,[ADDend] & 	 rustic, and 
 pale 	 pale; 
 beauty 	 beauty, 
[DELstart] allowed of[DELend][ADDstart] ^[ADDend][ADDstart] permitted[ADDend]  	 permitted 
[DELstart] feeling[DELend][ADDstart] sentiment[ADDend]  	 sentiment 
 William, 	 William; 
 it—While 	 it. While 
 engaged 	 engaged, 
 entered– 	 entered: 
 arrive 	 arrive, 
 the greatest 	 a sorrowful 
on seeing  me – "Welcome 	 to see me: “Welcome, 
 Victor," 	 Victor,” 
he,  ah 	 he. “Ah! 
[DELstart] weeks[DELend]  	[NO 1823 VARIANT]
 ago 	 ago, 
 found 	 found 
joy  – 	 joyous and delighted. 
[DELstart] all of us[DELend]  so unhappy that 	 unhappy; and, 
 afraid 	 afraid, 
[DELstart] for[DELend][ADDstart] ^[ADDend] will 	 will 
welcome [ADDstart] ^[ADDend][ADDstart] our[ADDend]  	 welcome. Our 
 sorrowful and it 	 sorrowful: this dreadful event 
sorrow  for 	 grief on 
Mamma and poor Eliza beth 	 mamma. Poor Elizabeth, also, 
 inconsolable." 	 inconsolable.” 
words.[ADDstart] ^[ADDend][ADDstart] you"[ADDend]  	 words.     “Do not,” 
 I," welcome 	 I, “Welcome 
calm [DELstart] and[DELend][DELstart] not letpreveng[DELend][DELstart] my being[DELend][ADDstart] preveng[ADDend][ADDstart] y[ADDend][ADDstart] ing[ADDend] that 	 calm, that 
be absolutely 	 be absolutely 
 fathers 	 father’s 
 But 	 But, 
How[ADDstart] does[ADDend]  	 how does 
support  	 support 
[DELstart] f[DELend]  misfortunes; 	 misfortunes ? 
Elizabeth?" She 	 Elizabeth?”     “She 
consolation," replied  Ernest–" She 	 consolation; she 
 brother 	 brother, 
 very, 	[NO 1823 VARIANT]
 wretched; but 	 wretched. But 
discovered"——" "Good God 	 discovered—”     “The murderer discovered! Good God! 
 Who 	 who 
im possible, 	 impossible; 
 winds 	 winds, 
 mountain stream 	 mountain-stream 
straw "I 	 straw.”     “I 
mean" replied  Ernest, But 	 mean; but 
 discovered–No 	 discovered. No 
[DELstart] one[DELend]  	[NO 1823 VARIANT]
 first 	 first; 
[DELstart] can[DELend][ADDstart] ^[ADDend][ADDstart] can[ADDend] Myrtella 	 Elizabeth 
convinced notwith  standing 	 convinced, notwithstanding 
 Indeed 	 Indeed, 
 could have believed 	 would credit 
 amiable 	 amiable, 
 family 	 family, 
wicked."[DELstart] "im[DELend]  "poor, 	 wicked?”     “Justine Moritz! Poor, 
 girl 	 girl, 
 then accused – but 	 the accused? But 
 wrongfully 	 wrongfully; 
 that. No 	 that; no 
[DELstart] bell[DELend]  	[NO 1823 VARIANT]
 it 	 it, 
Ernest?" "No 	 Ernest?”     “No 
first," said my brother,  "but 	 first; but 
[DELstart] things[DELend][ADDstart] ^[ADDend][ADDstart] circumstances[ADDend]  	 circumstances 
 will 	 that have almost 
us  	 us; 
 "own 	 own 
[DELstart] was so[DELend][ADDstart] ^[ADDend] has 	 has 
[DELstart] such[DELend]  	[NO 1823 VARIANT]
confused [DELstart] and[DELend]  	 confused, 
 that 	 that, 
 fear 	 fear, 
doubt:  but 	 doubt. But 
 "will 	 will be 
 today 	 to-day, 
[DELstart] e[DELend][DELstart] t[DELend][DELstart] opened[DELend][DELstart] search &[DELend][DELstart] nothing[DELend][DELstart] cou[DELend][DELstart] day after[DELend][DELstart] her bed— Her apparel was exami[DELend][DELstart] then[DELend]  	 all.”     He 
 that 	 that, 
[DELstart] after[DELend] on 	 on 
discovered [DELstart] Justine o[DELend]  	 discovered, 
 ill 	 ill, 
 bed, and 	 bed; and, 
 days 	 days, 
servants happen[DELstart] ed[DELend][ADDstart] ed[ADDend][ADDstart] ing[ADDend]  	 servants, happening 
murder [DELstart] &[DELend][DELstart] ard[DELend][ADDstart] ad[ADDend]  	 murder, had 
 mother 	 mother, 
 shewed 	 showed 
[DELstart] and[DELend][ADDstart] who[ADDend]  	 who, 
family [DELstart] they[DELend] went 	 family, went 
magistrate who sent to appre[DELstart] who[DELend]  on 	 magistrate; and, upon their deposition, Justine was apprehended. On 
fact[ADDstart] she[ADDend]  	 poor girl 
[DELstart] to[DELend][DELstart] a[DELend]  	[NO 1823 VARIANT]
 This 	 confusion of manner.     This 
 tale 	 tale, 
 faith 	 faith; 
earnest ly. "You 	 earnestly, “You 
 mistaken. 	 mistaken; 
 murderer 	 murderer. 
 Justine 	 Justine, 
 At 	 innocent.”     At 
en After 	 entered. I saw unhappiness deeply impressed on his countenance, but he endeavoured to welcome me cheerfully; and, after we had exchanged 
 first 	[NO 1823 VARIANT]
 greetings 	 greeting, would have introduced some other topic than that of our disaster, 
past [DELstart] and[DELend]  	 not 
 exclaimed Good 	 exclaimed, “Good 
Pa pa! 	 papa! 
[DELstart] has[DELend][DELstart] k[DELend][ADDstart] s[ADDend]  	[NO 1823 VARIANT]
William.[DELstart] And[DELend]  We 	 William.”     “We 
 unfortunately," 	 unfortunately,” 
 father for 	 father; “for 
[ADDstart] ^[ADDend] for 	 been for 
 than, 	 than 
 & 	 and 
 whom 	[NO 1823 VARIANT]
highly. "My 	 highly.”     “My 
 father" exclaimed I–"You 	 father, you 
 mistaken. 	 mistaken; 
innocent." "If she is" replied my father "God 	 innocent.”     “If she is, God 
  	[NO 1823 VARIANT]
[DELstart] innocent[DELend] guilty – 	 guilty. 
 today 	 to-day, 
 hope 	 hope, 
 hope 	 hope, 
acquitted This 	 acquitted.”     This 
 Justine 	 Justine, 
 being 	 being, 
 fear therefore 	 fear, therefore, 
 her and 	 her; and, 
 assurance 	 assurance, 
 myself 	 myself, 
 eagerness 	 eagerness, 
[DELstart] co[DELend][DELstart] our[DELend][DELstart] mournful[DELend][ADDstart] he[ADDend][ADDstart] ^[ADDend][ADDstart] after ourwe[ADDend]  	[NO 1823 VARIANT]
 We 	 We 
[ADDstart] ^[ADDend][ADDstart] by[ADDend]  	 by 
 Five 	 Six 
[DELstart] ago[DELend]  	[NO 1823 VARIANT]
 was 	 had been 
good humoured girl   Whom 	 good-humoured girl, whom 
 loved, 	 loved 
[DELstart] humoured[DELend][ADDstart] caressed[ADDend] . 	 caressed. 
 countenance 	 countenance, 
 lovely — 	 lovely. 
&[ADDstart] ^[ADDend][ADDstart] e[ADDend] head 	 and capacious forehead 
 understanding 	 understanding, 
 frankness. 	 frankness of disposition. 
 hazel 	 hazel, 
[DELstart] great[DELend][ADDstart] ive[ADDend][ADDstart] ^[ADDend][ADDstart] of uncommon[ADDend]  mildness now 	 expressive of mildness, now, 
 affliction 	 affliction, 
 sadness– 	 sadness. 
rich[ADDstart] ^[ADDend][ADDstart] dark[ADDend][ADDstart] ^[ADDend] her 	 rich dark auburn, her 
fair  	 fair, 
[DELstart] embraced[DELend][DELstart] w[DELend][DELstart] me with[DELend]  	[NO 1823 VARIANT]
 affection "Your 	 affection. “Your 
[DELstart] best[DELend][ADDstart] dearest[ADDend]  cousin," 	 dear cousin,” 
[DELstart] give[DELend]  "fills 	 “fills 
 out 	[NO 1823 VARIANT]
[DELstart] innocent[DELend][ADDstart] ^[ADDend][ADDstart] guiltless[ADDend]  	 guiltless 
Alas  Who 	 Alas! who 
 safe is 	 safe, if 
 were 	 be 
[DELstart] for[DELend][DELstart] belie[DELend][ADDstart] ^[ADDend][ADDstart] of crime?[ADDend]  	 of crime? I 
[DELstart] her[DELend]  	[NO 1823 VARIANT]
[ADDstart] Our[ADDend] Misfortune 	 Our misfortune 
us. [ADDstart] We[ADDend]  	 us; we 
 boy 	 boy, 
 girl 	 girl, 
  	[NO 1823 VARIANT]
 fate – Alas if 	 fate. If 
 condemned 	 condemned, 
 never 	[NO 1823 VARIANT]
 more 	 more. 
 not 	 not, 
 not 	 not; 
 again 	 again, 
[DELstart] d[DELend]  	[NO 1823 VARIANT]
William." "She 	 William.”     “She 
 Elizabeth," 	 Elizabeth,” 
 I and 	 I, “and 
 proved – 	 proved; 
 nothing 	 nothing, 
aquittal. "every 	 acquittal.”     “How kind you are! every 
wretched   	 wretched, 
 that 	 that 
 impossible, 	 impossible: 
 despairing." 	 despairing.” 
wept—  "Sweet niece" 	 wept.     “Sweet niece,” 
 father dry 	 father, “dry 
[DELstart] eyes[DELend][ADDstart] sorrowful[ADDend]  if 	 tears. If 
 is 	 is, 
 believe innocent 	 believe, innocent, 
[DELstart] that[DELend] on 	 on 
 judges & 	 judges, and 
partiality.  	 partiality.” 
 We 	 W E  
 hours untill 	 hours, until 
 o'clock 	 o’clock, 
[DELstart] begin[DELend][DELstart] and[DELend][ADDstart] commence[ADDend][ADDstart] M[ADDend] y 	 commence. My 
E[DELstart] father[DELend][DELstart] El[DELend]  	[NO 1823 VARIANT]
witnesses [DELstart] Iac[DELend]  	 witnesses, 
 sufferred 	 suffered 
torture.[ADDstart] ^[ADDend] It 	 torture. It 
 decided 	 decided, 
lawless[DELstart] desires[DELend][ADDstart] devices[ADDend]  	 lawless devices 
  	[NO 1823 VARIANT]
 fellow beings. One 	 fellow-beings: one 
 babe 	 babe, 
 joy, 	 joy; 
 murdered 	 murdered, 
agravation [DELstart] ignominy[DELend]  	 aggravation of 
 that 	 the 
[DELstart] more terrible[DELend] memorable 	 memorable 
 merit 	 merit, 
[DELstart] little world[DELend][ADDstart] life[ADDend]  happy; 	 life happy: 
an[DELstart] d[DELend]  	 an 
grave [ADDstart] ;[ADDend]  And 	 grave; and 
 Justine, 	 Justine; 
 committed 	 committed, 
have[ADDstart] been[ADDend]  	 have been 
 madman 	 madman, 
 could 	 would 
me.[DELstart] aff[DELend]  	 me.     The 
[DELstart] morn[DELend]  mourning 	 mourning; 
 rendered 	 rendered, 
feelings exquisite  -ly 	 feelings, exquisitely 
[DELstart] Yet she[DELend][DELstart] Her mann[DELend]  	[NO 1823 VARIANT]
 innocence 	 innocence, 
 tremble 	 tremble, 
 at 	 on 
thousands. [DELstart] fo[DELend]  For 	 thousands; for 
kind  ness 	 kindness 
 gained from others 	 excited, 
 rememberance 	 imagination 
 tranquil 	 tranquil, 
evident constrained – 	 evidently constrained; 
 guilt 	 guilt, 
[DELstart] herself[DELend]  	[NO 1823 VARIANT]
 court 	 court, 
 it 	 it, 
 seated – a 	 seated. A 
 us 	 us; 
 herself 	 herself, 
[DELstart] g[DELend][DELstart] with[DELend]  	[NO 1823 VARIANT]
look[DELstart] e[DELend]  	 look 
[DELstart] and[DELend]  and 	 guiltlessness.     The trial began; and, 
 charge 	 charge, 
 her 	 her, 
 would 	 might 
 prof 	 proof 
 committed 	 committed, 
[DELstart] farme[DELend] woman 	 market-woman 
 He 	 The woman 
wh[DELstart] She[DELend][ADDstart] The woman[ADDend][ADDstart] ^[ADDend][ADDstart] her[ADDend]  	[NO 1823 VARIANT]
there[DELstart] for[DELend][ADDstart] ?[ADDend][ADDstart] but[ADDend]  	 there; but 
[DELstart] stang[DELend]  strangely 	 strangely, 
[DELstart] e[DELend][DELstart] came[DELend][ADDstart] ^&unintelligible^[ADDend][ADDstart] ^[ADDend][ADDstart] She[ADDend]  	 and unintelligible answer. She 
 o'clock and 	 o’clock; and, 
 some 	[NO 1823 VARIANT]
 enquired 	 inquired 
 night 	 night, 
 child 	 child, 
[DELstart] enquired[DELend][ADDstart] ^[ADDend][ADDstart] demanded[ADDend] earnestly 	 demanded earnestly 
the body was brought into 	 shown 
 house 	 body, 
hys terics 	 hysterics, 
 produced 	 produced, 
 pocket 	 pocket; 
 Elizabeth 	 Elizabeth, 
 voice 	 voice, 
[DELstart] she had[DELend][DELstart] the[DELend][ADDstart] which[ADDend]  	 which, 
murder the 	[NO 1823 VARIANT]
missed, she 	 missed, she 
 neck 	 neck, 
 indignation 	 horror 
 horror 	 indignation 
court. Justine 	 court.     Justine 
 then 	[NO 1823 VARIANT]
  	[NO 1823 VARIANT]
 proceeded 	 proceeded, 
 Surprise horror 	 Surprise, horror, 
strong  ly 	 strongly 
tears [DELstart] wh[DELend]  but 	 tears; but, 
 speak 	 plead, 
 powers 	 powers, 
 audible 	 audible, 
 "God knows," 	 variable, voice:—     “God knows,” 
"[DELstart] w[DELend][ADDstart] w[ADDend]  	 “how 
 inocent. but 	 innocent. But 
to be  acquitted on account of 	 that 
[DELstart] a[DELend]  	[NO 1823 VARIANT]
[DELstart] facts[DELend][ADDstart] facts[ADDend]  	 facts 
 me, 	 me; 
 encline 	 incline 
 interpretation 	 interpretation, 
[DELstart] fact[DELend][ADDstart] circumstance[ADDend]  	 circumstance 
  	[NO 1823 VARIANT]
suspicious. She 	 suspicious.”     She 
 that 	 that, 
 Elizabeth 	 Elizabeth, 
 was perpetrated 	 had been committed 
[ADDstart] ^[ADDend] the 	 the 
 who resided in Chêne 	 at Chêne, 
 return 	 return, 
 o'clock 	 o’clock, 
[DELstart] servant[DELend] man 	 man, 
 frightened at 	 alarmed by 
 him 	 him, 
 shut 	 shut, 
[DELstart] passed[DELend][ADDstart] ^[ADDend] was 	 was 
night[ADDstart] in[ADDend]  	 night in a barn belonging to 
 but unable 	 being unwilling to call up the inhabitants, to whom she was well known. Unable 
 rose early 	 quitted her asylum early, 
[DELstart] [DELend][DELstart] e[DELend]  	 spot 
 lay 	 lay, 
knowledge [DELstart] and she had been confused[DELend] That if 	 knowledge. That 
ques  tioned 	 questioned 
 market woman, 	 market-woman 
[DELstart] that[DELend][ADDstart] not[ADDend]  surprising when 	 not surprising, since 
[DELstart] was so[DELend][DELstart] c[DELend][ADDstart] for[ADDend]  	 had passed a sleepless night, and 
 loss 	 fate 
 William. 	 William was yet uncertain. 
"I know," continued  	  
  	 “I know,” continued 
victim[DELstart] e[DELend]  "how 	 victim, “how 
[DELstart] o[DELend]  	[NO 1823 VARIANT]
[DELstart] we[DELend]  	[NO 1823 VARIANT]
 me 	 me, 
 it 	 it; 
 ignorance 	 ignorance, 
[DELstart] w[DELend] as any other is 	[NO 1823 VARIANT]
conject[DELstart] ure[DELend] to 	[NO 1823 VARIANT]
[DELstart] I[DELend]  	[NO 1823 VARIANT]
[DELstart] at a[DELend][DELstart] stand[DELend][ADDstart] checked[ADDend] I 	 checked. I 
 have 	[NO 1823 VARIANT]
earth   	 earth, 
 who could 	 would 
[DELstart] d[DELend]  	[NO 1823 VARIANT]
[DELstart] so cruelly[DELend][ADDstart] ^[ADDend][ADDstart] wantonly.[ADDend] Did 	 wantonly. Did 
doing  or 	 doing; or, 
 had 	 had, 
 jewel 	 jewel, 
[ADDstart] ^[ADDend][ADDstart] again[ADDend]  	 again 
soon [DELstart] again[DELend][ADDstart] ?[ADDend] "I 	 soon?     “I 
 judges 	 judges, 
 character 	 character; 
the[ADDstart] ir[ADDend] testimony 	 their testimony 
overweigh my 	 overweigh my 
guilt[DELstart] is an apparent[DELend]  	 guilt, 
[DELstart] shall[DELend][ADDstart] must[ADDend] be condemned 	 must be condemned, 
[DELstart] p[DELend]  	[NO 1823 VARIANT]
innocence." Several 	 innocence.”     Several 
 called 	 called, 
 years 	 years, 
 her 	 her; 
 fear 	 fear, 
 guilty 	 guilty, 
 timorous 	 timorous, 
speak[ADDstart] ^[ADDend] come 	 come 
 dispositions & 	[NO 1823 VARIANT]
  	[NO 1823 VARIANT]
 when 	 when, 
[DELstart] uncalled[DELend] she 	 violently agitated, she 
 speak. "I am" 	 address the court.     “I am,” 
 she "the 	 she, “the 
 murdered 	 murdered, 
 sister 	 sister, 
[ADDstart] ^[ADDend][ADDstart] by[ADDend]  	 by, 
[DELstart] s[DELend]  	[NO 1823 VARIANT]
[DELstart] sin[DELend]  	[NO 1823 VARIANT]
 birth; it 	 birth. It 
 occasion 	 occasion; 
 fellow creature 	 fellow-creature 
 friends 	 friends, 
 speak 	 speak, 
[DELstart] and[DELend]  	[NO 1823 VARIANT]
[DELstart] know a great deal[DELend][ADDstart] ^[ADDend] am 	 am 
it.[DELstart] for[DELend]  	 the accused. 
 her 	 her, 
 five 	 five, 
 afterwards 	 at another 
[DELstart] time[DELend][DELstart] [DELend][ADDstart] ^[ADDend][ADDstart] period[ADDend]  	 period she 
 a 	 the 
 creature. 	 of human creatures. 
 nurst 	 nursed Madame Frankenstein, 
 aunt 	 aunt, 
 illness 	 illness, 
 care 	 care; 
after  terwards 	 afterwards 
[ADDstart] ^[ADDend][ADDstart] own[ADDend]  	 own 
 long & 	[NO 1823 VARIANT]
illness [DELstart] w[DELend]  	 illness, 
 uncle's house 	 uncle’s house, 
[DELstart] always a favourite[DELend][ADDstart] ^[ADDend] beloved 	 beloved 
[DELstart] Of the deceased[DELend] she 	 She 
[DELstart] very[DELend][DELstart] fond[DELend][ADDstart] ^[ADDend] warmly 	 warmly 
has been murdered  	 is now dead, 
[DELstart] in[DELend]  	[NO 1823 VARIANT]
Mother for 	 mother. For 
 part 	 part, 
[DELstart] s[DELend][ADDstart] ^[ADDend][ADDstart] all[ADDend]  	 say, that, notwithstanding all 
  	[NO 1823 VARIANT]
 her 	 her, 
[DELstart] An[DELend]  	[NO 1823 VARIANT]
[DELstart] t[DELend][ADDstart] t[ADDend]  	 no 
[DELstart] and her dispo character[DELend][DELstart] whi[DELend]  	[NO 1823 VARIANT]
action[DELstart] is amiable[DELend][DELstart] for[DELend]  	 action: 
rests [DELstart] If[DELend][DELstart] s[DELend]  	 rests, 
 wished for it 	 desired it, 
 her 	 to her; 
[DELstart] did[DELend]  	[NO 1823 VARIANT]
[DELstart] I rely[DELend]  	[NO 1823 VARIANT]
her." Excellent 	 her.”     Excellent 
[DELstart] o[DELend]  	[NO 1823 VARIANT]
 heard, 	 heard; 
[DELstart] on her account[DELend][ADDstart] ^[ADDend] excited 	 excited 
interference & 	 interference, and 
 Justine 	 Justine, 
[DELstart] ig[DELend][ADDstart] was[ADDend]  	 indignation was 
her[ADDstart] with[ADDend]  	 her with 
in- [DELstart] For[DELend]  	 ingratitude. 
 spoke 	 spoke, 
agitation[ADDstart] ^[ADDend] & 	 agitation and 
[DELstart] wh[DELend]  	[NO 1823 VARIANT]
 of the 	[NO 1823 VARIANT]
  	[NO 1823 VARIANT]
inno cence 	 innocence; 
 monster 	 dæmon, 
 alo 	 also 
sport[ADDstart] have[ADDend]  	 sport have 
situa  tion 	 situation; 
 saw 	 perceived 
 voice 	 voice, 
 countenance 	 countenances 
 Judges 	 judges, 
[DELstart] her[DELend][ADDstart] Xthe accusedXmy unhappyvictim[ADDend] I 	 my unhappy victim, I 
 mine 	 mine; 
 innocence 	 innocence, 
 bosom– 	 bosom, and would not forego their hold.     
 question – 	 question; 
know[ADDstart] n[ADDend]  	 known, 
[DELstart] what I came to en-[DELend][ADDstart] ^[ADDend] the 	 the 
visit[DELstart] quire;[DELend]  — the 	 visit. The 
 thrown 	 thrown; 
[DELstart] blak[DELend][ADDstart] ^[ADDend][ADDstart] black[ADDend] & 	 black, and 
  	[NO 1823 VARIANT]
[ADDstart] 2[ADDend] I 	 I 
 attempt 	 pretend 
 felt – 	 felt. 
[DELstart] had[DELend][ADDstart] experienced[ADDend]  	 before experienced 
horror  before 	 horror; 
 on 	 upon 
 expressions 	 expressions, 
 now 	[NO 1823 VARIANT]
 any 	 an 
 heart sickening 	 heart-sickening 
felt[DELstart] Nor[DELend][ADDstart] ^[ADDend][ADDstart] endured[ADDend]  	 endured. 
 had 	[NO 1823 VARIANT]
 also added 	 added, 
 "That evidence" 	 “That evidence,” 
 observed –"was 	 observed, “was 
 case 	 case, 
 I 	[NO 1823 VARIANT]
 and indeed 	 and, indeed, 
[DELstart] ch[DELend]  	[NO 1823 VARIANT]
evi let 	 evidence, be 
be[ADDstart] ^[ADDend][ADDstart] it[ADDend]  	[NO 1823 VARIANT]
decisive." When 	 decisive.”     When 
 home 	 home, 
[DELstart] enquired[DELend][ADDstart] ^[ADDend][ADDstart] demanded[ADDend]  	 demanded 
 "My cousin" 	    “My cousin,” 
 "it 	 “it 
[ADDstart] ^[ADDend][ADDstart] all[ADDend] Judges 	 expected; all judges 
 suffer 	 suffer, 
 escape: but 	 escape. But 
confessed." This 	 confessed.”     This 
[DELstart] b[DELend]  	[NO 1823 VARIANT]
Eliza beth 	 Elizabeth, 
on  her 	 upon Justine’s 
 "Alas!" 	 “Alas!” 
 she "How 	 she, “how 
 benovolence – 	 benevolence? 
 sister. How 	 sister, how 
[DELstart] thos[DELend]  	[NO 1823 VARIANT]
 betray– 	 betray; 
inca pable 	 incapable 
 humour 	 humour, 
[DELstart] com[DELend]  	[NO 1823 VARIANT]
murder." Soon 	 murder.”     Soon 
 go 	 go; 
 said 	 said, 
 judgement 	 judgment 
 "Yes," 	 “Yes,” 
 Elizabeth "I 	 Elizabeth, “I 
 go 	 go, 
 guilty – 	 guilty; 
 you Victor 	 you, Victor, 
acco pany me –I 	 accompany me: I 
alone". [DELstart] This[DELend]  	 alone.” 
 me 	 me, 
refuse. We 	 refuse.     We 
prison cham ber 	 prison-chamber, 
 mannacled 	 manacled, 
[DELstart] knews[DELend]  knees,– she 	 knees. She 
[DELstart] th[DELend]  	[NO 1823 VARIANT]
 her 	 her, 
 Elizabeth 	 Elizabeth, 
bitterly. My 	 bitterly. My 
 also – Oh Justine 	 also.     “Oh, Justine!” 
 consolation – 	 consolation. 
[DELstart] believed[DELend][ADDstart] relied[ADDend][ADDstart] o[ADDend] n 	 relied on 
 innocence 	 innocence; 
[DELstart] wh[DELend]  wretched 	 wretched, 
now." "And 	 now.”     “And 
 very 	 very, 
wicked–?[ADDstart] ^[ADDend][ADDstart] Cried Justine[ADDend]  	 wicked? 
 me? 	 me?” 
sobs. "Rise 	 sobs.     “Rise, 
 girl," 	 girl,” 
Elizabeth  "why 	 Elizabeth, “why 
 kneel 	 kneel, 
innocen  	 innocent? 
 enemies, 	 enemies; 
in  your innocence 	 you guiltless, 
 evidence untill 	 evidence, until 
 report 	 report, 
 say 	 say, 
 false, 	 false; 
 assured my 	 assured, 
 Justine 	 Justine, that 
 for a minute 	[NO 1823 VARIANT]
confession–" "I did confess" said Justine "but 	 confession.”     “I did confess; but 
 confessed 	 confessed, 
 absolution 	 absolution; 
 condemned 	 condemned, 
  	 me; 
 menaced untill 	 menaced, until 
 wicked wretch 	 monster that 
 excomunication 	 excommunication 
 Hell 	 hell 
 moments 	 moments, 
 Lady, 	 lady, 
 me – 	 me; 
 doom 	 doomed 
 perdition; what 	 perdition. What 
[DELstart] confessed[DELend]  	[NO 1823 VARIANT]
 lie 	 lie; 
 am 	[NO 1823 VARIANT]
 miserable." 	 miserable.”     
continued.  "I 	 continued—“I 
[DELstart] sho[DELend]  	[NO 1823 VARIANT]
that  	[NO 1823 VARIANT]
 Justine 	 Justine, 
 bessed 	 blessed 
 honoured 	 honoured, 
 wretch 	 creature 
of[ADDstart] ^[ADDend][ADDstart] a[ADDend]  	 of a 
[DELstart] not[DELend][ADDstart] none[ADDend]  	 none 
[DELstart] was capable of[DELend][ADDstart] ^[ADDend] could 	 could 
 William, 	 William! 
 child, 	 child! 
heaven & glory 	 heaven, where we shall all be happy; 
 me 	 me, 
de[ADDstart] "[ADDend] Elizabeth, "forgive 	 death.”     “Oh, Justine! forgive 
you – [DELstart] But[DELend][ADDstart] you[ADDend]  	 you. Why did you 
 mourn 	 mourn, 
 girl, 	 girl; 
 innocence 	 innocence, 
 will 	[NO 1823 VARIANT]
die –  you 	 die; you, 
 companion, 	 playfellow, 
 playfellow, 	 companion, 
 sister— die –I never 	 sister. I 
misfortune". "Dear Sweet lady," 	 misfortune.”     “Dear, sweet Elizabeth, 
weep"– [DELstart] sai[DELend]  replied Justine"– you 	 weep. You 
[DELstart] w[DELend]  	[NO 1823 VARIANT]
[DELstart] world[DELend][ADDstart] life,[ADDend]  	 life, 
 strife –Do 	 strife. Do 
 Elizabeth 	 friend, 
despair."[DELstart] Em[DELend] er "I 	 despair.”     “I 
you," said she  	 you; 
 this 	 this, 
 fear 	 fear, 
consolation [DELstart] or[DELend]  	 consolation, 
 hope 	 hope. 
 resignation 	 resignation, 
hope a 	[NO 1823 VARIANT]
 Oh 	 Oh! 
 all 	[NO 1823 VARIANT]
 shews 	 shows 
 mockeries.– When 	 mockeries! when 
[DELstart] deprived of life[DELend][DELstart] they[DELend][DELstart] bel[DELend][ADDstart] murdered[ADDend] another 	 murdered, another 
[DELstart] another[DELend]  	 deprived 
[ADDstart] ^[ADDend] then 	 manner; then 
 executioners 	 executioners, 
in[ADDstart] nocence[ADDend]  	 innocence, 
[DELstart] things[DELend][ADDstart] deed[ADDend] . 	 deed. 
retribution; hate ful 	 retribution . Hateful 
[ADDstart] ^[ADDend][ADDstart] word[ADDend]  	 word 
 pronounced 	 pronounced, 
 that 	[NO 1823 VARIANT]
[ADDstart] ^[ADDend][ADDstart] ever[ADDend][ADDstart] t[ADDend][ADDstart] d[ADDend]  	 ever invented 
satiate his 	 satiate his 
[ADDstart] ^[ADDend][ADDstart] for[ADDend]  	 for 
[ADDstart] ^[ADDend] in 	 in 
 & 	 and 
[DELstart] in peace[DELend]  	 lovely William, 
 light 	 a world 
[DELstart] I abhor[DELend] is 	 is 
me  	 me, 
 Justine 	 I abhor.”     Justine 
 "This, 	 “This, 
Lady  said she 	 lady, 
 despair 	 despair, 
 me – talk of somthing else 	 me. Talk 
fields[DELstart] s[DELend]  of 	 something else, 
[DELstart] brig jo[DELend] bring joy 	 bring peace, 
 encrease 	 increase 
misery."  	 misery.” 
 prison-room 	 prison-room, 
 me– 	 me. 
 victim 	 victim, 
 of 	 between 
 & death 	 and death, 
 did — Such 	 did, such 
 & 	 and 
 agony 	 agony. 
 teeth 	 teeth, 
[DELstart] [DELend]  together 	 together, 
started [DELstart] and[DELend]  when 	 started. When 
 was 	 was, 
me. "Dear Sir," said  she, "you 	 me, and said, “Dear Sir, you 
 you 	 you, 
 hope 	 hope, 
[DELstart] "[DELend] I 	 guilty.”     I 
 answer – "No Justine" 	 answer. “No, Justine,” 
 "he 	 “he 
[DELstart] even[DELend]  	[NO 1823 VARIANT]
 was 	 was; 
 confessed 	 confessed, 
[DELstart] believe[DELend] "I 	 credit it.”     “I 
him"– said Justine  "In 	 him. In 
 minutes 	 moments 
 for 	 towards 
 still 	[NO 1823 VARIANT]
 am – 	 am! 
 misfortune 	 misfortune; 
[DELstart] pea[DELend][DELstart] thn[DELend]  	 peace, 
isacknow ledged 	 is acknowledged 
 sweet 	 dear 
cousin." Thus 	 cousin.”     Thus 
[DELstart] cr[DELend]  	[NO 1823 VARIANT]
wished for  but I 	 desired. But I, 
murderer [DELstart] w[DELend]  	 murderer, 
 never dying 	 never-dying 
[DELstart] and I was[DELend][ADDstart] which[ADDend] allowed 	 in my bosom, which allowed of 
 wept 	 wept, 
 unhappy 	 unhappy; 
[ADDstart] ^[ADDend][ADDstart] also[ADDend]  	 her’s also 
[DELstart] also[DELend]  	[NO 1823 VARIANT]
innocence [DELstart] that[DELend] which 	 innocence, which, 
[DELstart] that[DELend][ADDstart] that[ADDend]  	 that 
moon [DELstart] which[DELend][ADDstart] &[ADDend]  	 moon, 
 des 	 hides, 
[DELstart] disturb[DELend][ADDstart] destroy[ADDend]  	 tarnish 
brightness [DELstart] but[DELend][DELstart] misery[DELend][DELstart] &[DELend][DELstart] desp[DELend]  anguish 	 brightness. Anguish 
[DELstart] penetr[DELend]  	[NO 1823 VARIANT]
 heart – 	 heart; 
 me that 	 me, which 
[DELstart] diminish[DELend][ADDstart] extinguish.[ADDend] We 	 extinguish. We 
 Justine 	 Justine; 
[DELstart] with[DELend]  	[NO 1823 VARIANT]
 tore 	 could tear 
away  "I wish" 	 away. “I wish,” 
 she that 	 she, “that 
 you – 	 you; 
 misery." 	 misery.”     
 Cheerfullness 	 cheerfulness, 
 the 	 her 
 tears – "Farewell 	 tears. She embraced Elizabeth, and said, in a voice of half-suppressed emotion, “Farewell, 
 Elizabeth 	 Elizabeth, my beloved and only friend; 
you May 	 you; may 
 – live & 	 Live, and 
happy  to 	 happy, and 
[DELstart] of[DELend]  	[NO 1823 VARIANT]
so. As We returned 	 so.”     As we returned, 
You  do not know, 	 “You know not, 
[DELstart] w[DELend]  	[NO 1823 VARIANT]
 relieved 	 relieved, 
 peace 	 peace, 
 it 	 her guilty, 
[DELstart] such[DELend]  	 an 
 suffers – 	 suffers; 
 is 	 has 
 wicked 	 betrayed the trust I reposed in her, 
consoled."[DELstart] Sweet[DELend][ADDstart] Amiable[ADDend]  Cousin! Such 	 consoled.     Amiable cousin! such 
 thoughts 	 thoughts, 
[DELstart] &[DELend][DELstart] gentle tone[DELend]  	[NO 1823 VARIANT]
voice but I.—— I 	 voice. But I—I 
wretch [DELstart] none[DELend] none 	 wretch, and none 
suffered.  	 endured. 
 Nothing 	 N OTHING  
[ADDstart] ^[ADDend][ADDstart] than[ADDend]  when 	 to the human mind, than, after 
 mind has 	 feelings have 
[DELstart] S[DELend][ADDstart] quick[ADDend]  	 quick 
 for a 	 the 
 calm 	 calmness 
certainty to of inaction & 	[NO 1823 VARIANT]
[DELstart] which[DELend][ADDstart] s[ADDend][ADDstart] and[ADDend] deprives 	 which follows, and deprives 
[DELstart] mind[DELend][ADDstart] soul[ADDend]  	 soul 
 or 	 and 
died— She rested. [DELstart] But[DELend][ADDstart] &[ADDend]  	 died; she rested; and 
alive  the 	 alive. The 
 veins 	 veins, 
 & 	 and 
 heart 	 heart, 
remove–[DELstart] destroyed[DELend] leep 	 remove. Sleep 
 eyes. 	 eyes; 
 spirit 	 spirit, 
[DELstart] done[DELend][ADDstart] ^[ADDend] had 	 had 
 mischief beyond 	 mischiefbeyond 
[ADDstart] ^[ADDend][ADDstart] horrible,[ADDend]  	 horrible, 
[DELstart] hor[DELend][ADDstart] hor[ADDend]  more 	 more, 
 more 	 more, 
 my self) 	 myself) 
 in store. 	 behind. 
kind ness 	 kindness, 
[DELstart] benevolence[DELend][ADDstart] goodness[ADDend]  – 	 the love of virtue. 
 intentions 	 intentions, 
[ADDstart] ^[ADDend][ADDstart] could[ADDend]  	 should 
practise  	 practice, 
fellow [DELstart] But[DELend][ADDstart] N[ADDend] ow 	 fellow-beings. Now 
blasted[ADDstart] ;[ADDend]  Instead 	 blasted: instead 
 conscience 	 conscience, 
 on my actions 	 upon the past 
self satis faction, 	 self-satisfaction, 
[ADDstart] ^[ADDend] to 	 to 
hopes  . 	 hopes, 
 and 	 which 
[DELstart] no tongue[DELend] of 	 of 
 tortures 	 tortures, 
 This 	 describe.     This 
[DELstart] allt[DELend][DELstart] altered[DELend] preyed 	 preyed 
 health 	 health, 
[DELstart] nearly[DELend][ADDstart] entirely[ADDend]  	 entirely 
 Solitude 	 solitude 
 consolation deep, 	 consolation—deep, 
[DELstart] night[DELend] death-like 	 death-like 
[DELstart] how[DELend] the 	 the 
 dispositions & 	 disposition and 
[DELstart] were altered[DELend]  	[NO 1823 VARIANT]
 "Do 	 “Do 
 Victor" 	 Victor,” 
he  "That 	 he, “that 
 also– no 	 also? No 
[DELstart] d[DELend][ADDstart] ^[ADDend][ADDstart] could[ADDend] a 	 could love a 
[DELstart] did[DELend][ADDstart] loved[ADDend]  	 loved 
brother– [DELstart] and[DELend]  tears 	 brother;” (tears 
[DELstart] into[DELend]  	[NO 1823 VARIANT]
 said this) but 	 spoke); “but 
[DELstart] our[DELend][ADDstart] a[ADDend]  	 a 
 add 	[NO 1823 VARIANT]
grief of[DELstart] owed[DELend][DELstart] ir[DELend][DELstart] not[DELend][DELstart] add to[DELend][ADDstart] ^[ADDend] that 	 survivors, that 
[DELstart] adding to[DELend]  	 augmenting 
 grief. 	 grief? 
day[ADDstart] ly[ADDend]  usefullness 	 daily usefulness, 
  	 society.” 
 This 	 This 
utterly inna plicable 	 totally inapplicable 
 grief 	 grief, 
 friends 	 friends, 
 despair 	 despair, 
[DELstart] also[DELend]  	[NO 1823 VARIANT]
[DELstart] chal[DELend]  	[NO 1823 VARIANT]
very  agreable 	 particularly agreeable 
 me in particular. 	 me. 
 of the town 	[NO 1823 VARIANT]
 o'clock 	 o’clock, 
[DELstart] stay[DELend][DELstart] ing[DELend][ADDstart] ^[ADDend][ADDstart] ing[ADDend][ADDstart] remaining[ADDend]  	 remaining 
 hour 	 hour, had 
 free: often, 	 free. Often, 
 night 	 night, 
 boat 	 boat, 
the  night 	 many hours 
 water: sometimes 	 water. Sometimes, 
 set 	 set, 
 wind 	 wind; 
 sometimes 	 sometimes, 
[DELstart] wo[DELend]  	[NO 1823 VARIANT]
 lake 	 lake, 
[DELstart] take[DELend][ADDstart] ^[ADDend][ADDstart] pursue[ADDend]  	 pursue 
 course 	 course, 
[DELstart] followed[DELend][ADDstart] ^[ADDend] gave 	 gave 
tempted [DELstart] w[DELend]  	 tempted, 
[DELstart] quiet[DELend][ADDstart] ^[ADDend][ADDstart] at peace[ADDend] around me 	 at peace around me, 
  	[NO 1823 VARIANT]
[ADDstart] &[ADDend]  heavenly; 	 and heavenly, 
 alone 	[NO 1823 VARIANT]
the[ADDstart] ^[ADDend] frogs, 	 the frogs, 
[DELstart] of the frogs[DELend][DELstart] which[DELend][DELstart] I[DELend][ADDstart] was[ADDend]  	 was 
 shore; often 	 shore—often, 
[DELstart] still and[DELend]  	[NO 1823 VARIANT]
lake [DELstart] and let[DELend][ADDstart] that[ADDend]  	 lake, that 
waters[ADDstart] >^[ADDend][ADDstart] might[ADDend]  	 waters might 
& my 	 and my 
 restrained 	 restrained, 
[ADDstart] &[ADDend] suffering Elizabeth 	 and suffering Elizabeth, 
 And then 	[NO 1823 VARIANT]
 father 	 father, 
brother; [DELstart] And[DELend] should 	 brother: should 
 not 	[NO 1823 VARIANT]
 & 	 and 
[DELstart] I[DELend]  	[NO 1823 VARIANT]
 lose 	 loose 
 bitterly 	 bitterly, 
[DELstart] if[DELend]  	[NO 1823 VARIANT]
— that 	 that 
 happiness — but 	 happiness. But 
[DELstart] took away[DELend][ADDstart] extinguished[ADDend]  	 be. Remorse extinguished 
 hope— 	 hope. 
[DELstart] cause[DELend][ADDstart] author[ADDend]  	 author 
 evil, 	 evils; 
fear [ADDstart] let[ADDend]  	 fear, lest 
might [DELstart] commit[DELend][ADDstart] perpetrate[ADDend] some 	 should perpetrate some 
 –I 	 I 
a[ADDstart] n[ADDend][ADDstart] obscure[ADDend]  	 an obscure 
[DELstart] cr[DELend]  crime 	 crime, 
 would 	 should 
 There 	 There 
 fear 	 fear, 
 that 	[NO 1823 VARIANT]
  	 behind. 
 conceived – 	 conceived. 
 him 	 him, 
 teeth 	 teeth, 
inflam ed 	 inflamed, 
[DELstart] though[DELend]  	[NO 1823 VARIANT]
moderation   	 moderation. 
highest peak 	 highest peak 
 Andes 	 Andes, 
 I 	 I, 
 there 	 there, 
[DELstart] foot[DELend][ADDstart] base[ADDend] ; 	 base. 
 but 	[NO 1823 VARIANT]
 again 	 again, 
 head 	 head, 
Justine. Our 	 Justine.     Our 
[DELstart] now[DELend]  	[NO 1823 VARIANT]
 mourning, my father's 	 mourning. My father’s 
 desponding 	 desponding; 
 sacriledge towards 	 sacrilege toward 
eter woe 	 eternal woe 
creature [DELstart] she had been when[DELend][DELstart] last saw her[DELend] who 	 creature, who 
had [DELstart] – who[DELend][ADDstart] had[ADDend]  	[NO 1823 VARIANT]
[DELstart] on[DELend]  	[NO 1823 VARIANT]
 lake 	 lake, 
 extacy 	 ecstacy 
 prospects– 	 prospects. 
[DELstart] was[DELend] had 	 had 
[DELstart] talked[DELend]  	 conversed 
 fortune 	 fortune, 
life—  "When 	 life.     “When 
 Cousin," she 	 cousin,” 
 "on 	 she, “on 
[DELstart] things[DELend]  	[NO 1823 VARIANT]
 in the same light 	[NO 1823 VARIANT]
[DELstart] Stories[DELend][ADDstart] ^[ADDend][ADDstart] me.[ADDend] I 	 me. Before, I 
 injustice 	 injustice, 
 others 	 others, 
 days 	 days, 
evils[ADDstart] ;[ADDend] At 	 evils; at 
  	[NO 1823 VARIANT]
imagination  	 the imagination; 
 home 	 home, 
 others 	 other’s 
 unjust.–Every one 	 unjust. Every body 
 guilty, 	 guilty; 
[DELstart] had[DELend][ADDstart] ^[ADDend] could 	 could 
[DELstart] she not[DELend]  	[NO 1823 VARIANT]
[ADDstart] ^[ADDend][ADDstart] human[ADDend]  	 human 
 jewels 	 jewels, 
 & 	 and 
 birth 	 birth, 
[DELstart] its[DELend]  	[NO 1823 VARIANT]
 own. 	 own! 
being [DELstart] yet[DELend][ADDstart] but[ADDend]  	 being; but 
[DELstart] woman[DELend][DELstart] unworthy of life[DELend][DELstart] as[DELend][ADDstart] being[ADDend]  	 creature 
 – 	[NO 1823 VARIANT]
she[DELstart] she[DELend]  	 she 
inno[DELstart] –[DELend] I 	 innocent. I know, I 
 innocent You 	 innocent; you 
 opinion 	 opinion, 
 Alas, Victor! 	 Alas! Victor, 
[DELstart] lies[DELend][DELstart] appear[DELend][DELstart] look[DELend][ADDstart] ^[ADDend][ADDstart] falsehood look[ADDend]  	 falsehood 
them  selves 	 themselves 
 precipiece 	 a precipice, 
crowding & endeavouring 	 crowding, and endeavouring 
  	 abyss. 
 & 	 and 
assassi nated 	 assassinated, 
escap[ADDstart] es[ADDend] human lineaments; 	 escapes; 
abou[ADDstart] t[ADDend] the 	 about the 
 free & 	 free, and 
[DELstart] if[DELend]  	[NO 1823 VARIANT]
[DELstart] tomo[DELend]  	[NO 1823 VARIANT]
 condemmed 	 condemned 
 crimes 	 crimes, 
wretch." I 	 wretch.”     I 
 agony – I – 	 agony. I, 
[DELstart] ind[DELend][ADDstart] ^[ADDend][ADDstart] in[ADDend]  deed 	 in deed, 
 effect 	 effect, 
 murderer.— 	 murderer. 
hand  said–"My 	 hand, said, “My 
 yourself; these 	 yourself. These 
affect  ed me 	 affected me, 
 deeply! 	 deeply; 
 misery 	 despair, 
 revenge 	 revenge, 
 countenance 	 countenance, 
 tremble; be 	 tremble. Be 
[DELstart] beloved[DELend][DELstart] best[DELend][ADDstart] ^[ADDend][ADDstart] best[ADDend] Victor, 	 dear Victor; 
happy; [DELstart] quite[DELend] quiet 	 happy: quiet 
 country 	 country, 
  	[NO 1823 VARIANT]
 world 	 world, 
tranquillity?" She 	 tranquillity?”     She 
this  distrusting 	 this, distrusting 
 which 	 that 
[DELstart] but[DELend][ADDstart] but[ADDend]  	 gave; but 
 father 	 father, 
 face, 	 face 
[DELstart] w[DELend]  	[NO 1823 VARIANT]
 feel 	 feel, 
 serenity – 	 serenity. 
[DELstart] th[DELend]  	[NO 1823 VARIANT]
[DELstart] a[DELend]  	 he 
country &[DELstart] from[DELend][ADDstart] induced by[ADDend] the 	 country; and, induced by the 
 reasons 	 motive, 
[DELstart] I[DELend]  	[NO 1823 VARIANT]
[DELstart] tak[DELend] journey 	 make an excursion 
 Valley 	 valley 
C[ADDstart] ^[ADDend][ADDstart] h[ADDend] amounix. 	 Chamounix. 
 before 	 before, 
 & 	 and 
 had, 	 had; 
 a wish 	 an earnest desire 
 place 	 place, 
 & 	 and 
august [DELstart] more[DELend][DELstart] than[DELend]  	 August, 
Justine. The 	 Justine.     The 
 beautiful 	 uncommonly fine; 
[DELstart] d[DELend]  	 mine 
 circumstance 	 circumstance, 
 voyage 	 excursion 
[DELstart] which[DELend] intended 	 intended 
father [DELstart] intended[DELend] . 	 father. 
  	 was, I 
I wa[DELstart] and sometimes[DELend][DELstart] amused.[DELend][DELstart] somehow[DELend][ADDstart] somewhat[ADDend][ADDstart] in the scene..it sometimes[ADDend][ADDstart] lulled, it[ADDend]  	 somewhat interested in the scene; it sometimes lulled, although it 
grief.[ADDstart] during[ADDend] The 	 grief. During the 
distance  to 	 distance, towards 
[DELstart] Br[DELend] We 	 We 
 Arve 	 river Arve, 
 degrees 	 degrees; 
 set 	 set, 
 saw 	 beheld 
&preci pieces 	 and precipices 
[DELstart] each[DELend][DELstart] of us[DELend][ADDstart] every[ADDend] & 	 every side, and 
[DELstart] moun[DELend] the 	 the 
raging[DELstart] tain[DELend][DELstart] streams[DELend] among 	 raging among 
the [DELstart] .[DELend][ADDstart] around.[ADDend] The 	 water-falls around.     The 
 on mules 	 upon mules; 
 higher; 	 higher, 
beautiful & verdant appear ance – 	 magnificent and astonishing character. 
[DELstart] built[DELend][ADDstart] ^[ADDend][ADDstart] builthanging[ADDend]  	 hanging 
 & 	 and 
 beauty.. 	 beauty. 
augment[ADDstart] ed[ADDend] rendered 	 augmented and rendered 
 alps 	 Alps, 
[ADDstart] &[ADDend]  	 and 
[DELstart] pir[DELend] piramids & 	 pyramids and 
[DELstart] the[DELend]  	 all, as belonging to 
earth —the  	 earth, the 
of beings[DELstart] e[DELend]  after we entered the valley 	[NO 1823 VARIANT]
[DELstart] wondeful[DELend] We 	 beings.     We 
[DELstart] Pellisier[DELend] Pellissier, 	 Pelissier, 
 ravine 	 ravine, 
 forms 	 forms, 
 us 	 us, 
 which over hung it–. 	 that overhangs it. 
 Valley 	 valley 
 sublime 	 sublime, 
 & 	 and 
 Servox; 	 Servox, 
 & 	 and 
w[DELstart] h[DELend] ere 	 were 
 boundaries 	 immediate boundaries; 
[DELstart] t[DELend]  	[NO 1823 VARIANT]
 or 	 and 
road, [DELstart] and[DELend]  	 road; 
 Avelanche 	 avelânche, 
 passage.–Mont 	 passage. Mont 
 supreme & 	 supreme and 
 Blanc 	 Blanc, 
  	 aiguilles , 
tremen  	 tremendous  dome  
valley. During 	 valley.     During 
 journey 	 journey, 
 Elizabeth 	 Elizabeth, 
 scene.— And often 	 scene. 
[DELstart] let my[DELend]  	 often 
 behind & 	 behind, and 
  	[NO 1823 VARIANT]
[DELstart] my mule[DELend] the 	 the 
 companions 	 companions, 
 and 	 and, 
 all 	 all, 
 distance 	 distance, 
 alighted 	 alighted, 
grass [DELstart] to shut out[DELend]  	 grass, 
 & 	 and 
 we 	 I 
[DELstart] Myrtella[DELend][DELstart] was[DELend][ADDstart] ^[ADDend] My 	 My 
 & 	 and 
fatigued. [DELstart] a[DELend]  Ernest 	 fatigued; Ernest, 
 us 	 us, 
 delighted 	 delighted, 
 spirits– The 	 spirits; the 
 wind 	 wind, 
 that that wind 	 it 
[DELstart] us[DELend]  	[NO 1823 VARIANT]
day. We 	 day.     We 
 appartments 	 apartments, 
 sleep:– 	 sleep; 
 window 	 window, 
[ADDstart] ^[ADDend][ADDstart] pallid[ADDend]  	 pallid 
 Blanc – 	 Blanc, 
 Arve 	 Arve, 
 before 	 below 
 he 	 T HE  
 prognostics 	 prognostications 
 fine 	 fine, 
[ADDstart] ^[ADDend][ADDstart] We[ADDend]  	 We 
 Aveiron 	 Arveiron, 
[DELstart] the whole da[DELend] until 	 until 
 receiving 	 receiving. 
 feeling 	 feeling; 
[DELstart] d[DELend]  	[NO 1823 VARIANT]
 grief 	 grief, 
[DELstart] t[DELend]  	[NO 1823 VARIANT]
 tranquilized 	 tranquillized 
 also 	 also, 
[ADDstart] ^[ADDend] over 	 over 
[DELstart] over[DELend] for 	 for 
month[DELstart] s[DELend] . 	 month. 
 fatigued 	 fatigued, 
 unhappy 	 unhappy, 
 convered 	 conversed 
 the 	 my 
[DELstart] t[DELend]  	[NO 1823 VARIANT]
[DELstart] I[DELend]  	[NO 1823 VARIANT]
[DELstart] accustomed[DELend] my 	 my 
 pleased 	 pleased, 
 overjoyed; "My 	 overjoyed. “My 
 Cousin," 	 cousin,” 
 "You 	 “you 
[DELstart] cheerful[DELend][ADDstart] happy[ADDend] ; 	 happy; 
again!— The 	 again!”     The 
 torrents 	 torrents, 
 early 	 early, 
[ADDstart] ^[ADDend][ADDstart] me[ADDend] , 	 me; 
 recurred 	 recurred, 
 dissapointed 	[NO 1823 VARIANT]
 change 	 change, 
 untill 	 until 
[DELstart] rev[DELend]  	[NO 1823 VARIANT]
 the 	 those 
 me — 	 me. 
 inn 	 inn; 
[DELstart] n[DELend] ever 	 ever 
 rain 	 rain, moisture, 
 cold 	 cold, 
[DELstart] t[DELend]  	[NO 1823 VARIANT]
[DELstart] by myself[DELend][ADDstart] alone[ADDend] . 	 Montanvert. 
 ever moving 	 ever-moving 
[DELstart] had[DELend][ADDstart] produced[ADDend] upon 	 produced upon 
it [DELstart] how[DELend][ADDstart] I[ADDend] t 	 it. It 
 extacy 	 ecstacy 
 soul 	 soul, 
[ADDstart] ^[ADDend][ADDstart] it[ADDend]  	 it 
[DELstart] lower[DELend][ADDstart] obscure[ADDend]  	 obscure 
 & 	 and 
 & 	 and 
[DELstart] tranquillizing the[DELend][ADDstart] ^[ADDend][ADDstart] solemnizing[ADDend][ADDstart] ^[ADDend][ADDstart] my[ADDend]  mind & 	 solemnizing my mind, and 
 the 	[NO 1823 VARIANT]
[DELstart] by myself[DELend][ADDstart] alone[ADDend] for 	 alone, for 
 path 	 path, 
[DELstart] had the effect of[DELend][DELstart] ing[DELend][ADDstart] would[ADDend]  	 would destroy 
[DELstart] solitary[DELend] solitary 	 solitary 
scene. The 	 scene.     The 
[DELstart] to the mountain[DELend][DELstart] with[DELend][ADDstart] ^[ADDend][ADDstart] is[ADDend][ADDstart] ^[ADDend][ADDstart] ^[ADDend] but 	 is precipitous, but 
 windings 	 windings, 
enable[DELstart] s[DELend][DELstart] to[DELend]  	 enable 
 perpedicularity 	 perpendicularity 
 mountains– 	 mountain. 
terrifical  ly 	 terrifically 
 places 	 spots 
 avelanche 	 avelânche 
 perceived 	 perceived, 
 destroyed 	 destroyed, 
 bent 	 bent, 
  	[NO 1823 VARIANT]
[DELstart] juts in[DELend]  	[NO 1823 VARIANT]
[DELstart] corners[DELend][ADDstart] rocks[ADDend]  	 rocks 
[ADDstart] ^[ADDend][ADDstart] transversely[ADDend]  	 transversely 
 path 	 path, 
[DELstart] ascen[DELend]  	[NO 1823 VARIANT]
 higher 	 higher, 
inters[DELstart] persed[DELend][ADDstart] ected[ADDend][ADDstart] by[ADDend]  	 intersected by 
 the 	[NO 1823 VARIANT]
dange rous 	 dangerous, 
 sound 	 sound, 
[ADDstart] even[ADDend] speaking 	 even speaking 
 voice 	 voice, 
[ADDstart] t[ADDend]  	[NO 1823 VARIANT]
 here 	[NO 1823 VARIANT]
 luxuriant 	 luxuriant, 
 sombre 	 sombre, 
[DELstart] gravit[DELend][ADDstart] severity[ADDend]  	 severity 
beneath.[ADDstart] ;[ADDend]  Vast mist 	 beneath; vast mists 
 river 	 rivers 
[DELstart] t[DELend][ADDstart] ^[ADDend][ADDstart] it[ADDend]  	 through it, 
 mountains 	 mountains, 
 sky 	 sky, 
 me — 	 me. 
[DELstart] who can boast[DELend]  	[NO 1823 VARIANT]
 above 	 superior to 
 brute 	 brute; 
  	[NO 1823 VARIANT]
 hunger thirst 	 hunger, thirst, 
 desire 	 desire, 
[DELstart] more[DELend][ADDstart] nearly[ADDend]  free 	 nearly free; 
[DELstart] sc[DELend]  	 blows, and a 
[DELstart] work[DELend]  	[NO 1823 VARIANT]
  	[NO 1823 VARIANT]
win  	 word 
 We rest, A 	 us.       We rest; a 
  sleep 	 sleep.     
 rise 	 rise; 
 wandering 	 wand’ring 
 day 	 day.     
 feel 	 feel, 
 reason – 	 reason; 
 weep 	 weep,     
 woe 	 woe, 
 It 	 away;     It 
 same –for 	 same: for, 
 sorrow 	 sorrow,     
free  Mans 	 free.     Man’s 
 ne'er 	 ne’er 
 morrow 	 morrow;     
mutability.[ADDstart] t[ADDend]  	 mutability!       It 
[DELstart] mountain[DELend][ADDstart] ascent[ADDend] . 	 ascent. 
 the 	[NO 1823 VARIANT]
 untains 	 mountains. 
 mist 	 cloud, 
 on 	 upon 
[DELstart] ice[DELend][DELstart] s[DELend][ADDstart] glacier[ADDend]  – 	 glacier. 
 uneven 	 uneven, 
[DELstart] tow[DELend]  	 descending 
& in[ADDstart] t[ADDend] erspered 	 and interspersed 
 deep— 	 deep. 
 width 	 field 
the[ADDstart] field of[ADDend] ice 	 ice 
[DELstart] nearly[DELend]  	 almost 
[DELstart] lege[DELend][ADDstart] ^[ADDend] in 	 league in 
 was 	 spent 
it – Theoppo[DELstart] t[DELend]  	 it. The opposite 
 rock.–From that 	 rock. From the 
 opposite 	 opposite, 
 league 	 league; 
[DELstart] l[DELend] lighted a fire and sitting by 	[NO 1823 VARIANT]
he  it 	[NO 1823 VARIANT]
 Blanc 	 Blanc, 
 rock 	 rock, 
& stupedous scene –  the sea 	 and stupendous scene. The sea, 
[DELstart] the[DELend]  	[NO 1823 VARIANT]
dependant  aerial 	 dependent mountains,whose aërial 
 Thier 	 Their 
 & 	 and 
  	[NO 1823 VARIANT]
heart [DELstart] sad[DELend][ADDstart] ^[ADDend] which 	 heart, which 
 somthing 	 something 
[DELstart] I clas[DELend]  	 joy; 
 exclaimed – Wandering 	 exclaimed—“Wandering 
 wander 	 wander, 
 happiness 	 happiness, 
 me 	 me, 
compa nion 	 companion, 
 life." 	 life.”     
 this 	 this, 
[DELstart] human[DELend][ADDstart] the[ADDend] figure 	 the figure 
man  	 man, 
 distance 	 distance, 
 speed— 	 speed. 
 ice 	 ice, 
 caution, 	 caution; 
 also 	 also, 
approached seem  ed 	 approached, seemed 
 man –I 	 man. I 
 troubled — 	 troubled: 
 covered 	 came over 
 eyes 	 eyes, 
[DELstart] ready to pa faint[DELend] faintness 	 a faintness 
me. of 	 me; but I was quickly restored by 
mountains quickly restored me. [DELstart] But[DELend]  	 cold gale of the mountains. 
 perceived 	 perceived, 
nearer[DELstart] oh[DELend]  sight 	 nearer, (sight 
 abhorred) 	 abhorred!) 
had [DELstart] cr[DELend] who 	[NO 1823 VARIANT]
caused me such deep misery . 	 created. 
[DELstart] an[DELend]  	[NO 1823 VARIANT]
horror [DELstart] determin[DELend][DELstart] ing[DELend][DELstart] g[DELend][ADDstart] I[ADDend][ADDstart] resolved[ADDend]  	 horror, resolving 
 approach& 	 approach, and 
I [DELstart] saw again that form from which[DELend][DELstart] I[DELend]  His 	 his 
 anguish 	 anguish, 
 malignancy. 	 malignity, while its unearthly ugliness rendered it almost too horrible for human eyes. 
[DELstart] hardly[DELend][ADDstart] ^[ADDend][ADDstart] scarcely[ADDend]  	 scarcely 
 this–anger 	 this; anger 
[DELstart] at f[DELend]  	[NO 1823 VARIANT]
 utterance 	 utterance, 
[DELstart] express[DELend]  	[NO 1823 VARIANT]
 utter 	 furious 
[DELstart] and[DELend][DELstart] re[DELend]  	[NO 1823 VARIANT]
 contempt – "Devil" 	 contempt.     “Devil!” 
 exclaimed – "do 	 exclaimed, “do 
 me 	 me? 
[ADDstart] ^[ADDend][ADDstart] you[ADDend]  dread 	 you fear 
 head – Begone 	 head? Begone, 
 insect 	 insect! 
[ADDstart] ^[ADDend][ADDstart] rather[ADDend]  Stay 	 rather stay, 
 dust and oh 	 dust! and, oh, 
 could 	 could, 
[DELstart] end[DELend][ADDstart] ^[ADDend][ADDstart] the end[ADDend] extinction 	 the extinction 
 existence 	 existence, 
 creatures 	 victims 
diabollicaly murdered" "I 	 so diabolically murdered!”     “I 
 reception" 	 reception,” 
dæmon  all 	 dæmon. “All 
[ADDstart] ^[ADDend][ADDstart] the[ADDend]  wretched – 	 the wretched; 
 hated 	 hated, 
[DELstart] conception or[DELend][DELstart] idea[DELend] all 	 all 
things.  – 	 things! 
you [DELstart] my[DELend]  	 you, 
 creator hate me 	 creator, detest 
me[DELstart] me[DELend]  	 me, 
 creature 	 creature, 
 with 	 by 
 death 	 annihilation 
[DELstart] And[DELend][DELstart] wish[DELend][ADDstart] Y[ADDend][ADDstart] purpose[ADDend]  	 You purpose 
[DELstart] And[DELend][ADDstart] H[ADDend] ow 	 How 
 me 	 me, 
& the 	 and the 
[ADDstart] ^[ADDend] If 	 If 
conditions  –I 	 conditions, I 
 peace – 	 peace; 
as I am if  but 	[NO 1823 VARIANT]
refuse  	 refuse, 
[ADDstart] ^[ADDend][ADDstart] will[ADDend]  	 will 
[DELstart] t[DELend]  	[NO 1823 VARIANT]
 death untill 	 death, until 
[DELstart] satiate[DELend]  	[NO 1823 VARIANT]
 even 	[NO 1823 VARIANT]
[DELstart] Miserable[DELend][DELstart] wretch[DELend] cried I furiously, 	 remaining friends.”     “Abhorred monster! 
 art 	 art! 
 Hell 	 hell 
[DELstart] soft for thee[DELend] mild 	 mild 
crimes. wretched 	 crimes. Wretched 
 come, 	 come on then, 
 that 	 which 
 bestowed." 	 bestowed.”     
 bounds 	 bounds; 
 sprung 	 sprang 
him [DELstart] that I[DELend][DELstart] and[DELend][DELstart] might destroy so hateful a monster–[DELend][DELstart] and[DELend][ADDstart] and[ADDend]  	 him, 
another. He 	 another.     He easily 
[ADDstart] me easily,[ADDend]  	 me, 
 said – Be 	 said,     “Be 
[DELstart] h[DELend]  	[NO 1823 VARIANT]
[ADDstart] up[ADDend] on 	 on 
head–[ADDstart] .[ADDend]  	 head. 
suffer[DELstart] r[DELend] ed enough 	 suffered enough, 
[DELstart] should[DELend]  wish 	 seek 
 encrease 	 increase 
 misery–Life 	 misery? Life, 
 be 	 may 
 anguish 	 anguish, 
 me 	 me, 
 it remember 	 it. Remember, 
[ADDstart] ^[ADDend][ADDstart] r[ADDend] ful 	 powerful 
 thyself 	 thyself; 
 yours 	 thine; 
[DELstart] do not wish to trave[DELend][DELstart] you[DELend] will 	 will 
thee,  	 thee. 
 creature 	 creature, 
you[ADDstart] to thee[ADDend] , 	[NO 1823 VARIANT]
gentle master my 	[NO 1823 VARIANT]
 master & 	 lord and 
 – 	[NO 1823 VARIANT]
[DELstart] you[DELend][ADDstart] thou[ADDend]  will 	 thou wilt also 
[DELstart] your[DELend] thy part also, 	 thy part, 
me[DELstart] towards[DELend][ADDstart] ies[ADDend][ADDstart] ^[ADDend]  	[NO 1823 VARIANT]
 Oh 	 Oh, 
 do 	 be 
[ADDstart] be[ADDend]  	[NO 1823 VARIANT]
 other 	 other, 
[ADDstart] alone[ADDend]  	 alone, 
 justice & 	 justice, and 
[DELstart] mere[DELend][DELstart] charity[DELend][ADDstart] they clemency, thy affection[ADDend]  	 thy clemency and affection, 
[DELstart] Remb[DELend]  Remember 	 Remember, 
 creature – 	 creature: 
Thy Adam – [ADDstart] ^[ADDend] but 	 thy Adam; but 
angel [DELstart] for[DELend] whom 	 angel, whom 
 driven 	 drivest 
misdeed;  every 	 misdeed. Every 
 bliss 	 bliss, 
whi[DELstart] ile[DELend][ADDstart] ch[ADDend]  	 which 
 alome 	 alone 
irrecoverably [DELstart] wretched[DELend][ADDstart] excluded[ADDend] . 	 irrevocably excluded. 
 good: 	 good; 
 happy 	 happy, 
virtuous Begone replied I – 	 virtuous.”     “Begone! 
[DELstart] cannot and[DELend] will 	 will 
 there 	 There 
 I– We 	 me; we 
 enemies — Begone 	 enemies. Begone, 
[DELstart] allhow[DELend]  	[NO 1823 VARIANT]
streng[DELstart] h[DELend] th 	 strength 
 fight 	 fight, 
fall."[DELstart] How[DELend]  How 	 fall”     “How 
you? said the  fiend— 	 thee? 
 you 	 thee 
 creature 	 creature, 
 compassion – 	 compassion. 
 Frankenstien 	 Frankenstein: 
 benevolent —my 	 benevolent; my 
  	[NO 1823 VARIANT]
 humanity 	 humanity: 
 alone 	 alone, 
alone – [DELstart] and[DELend]  	 alone? 
 creator 	 creator, 
me  What 	 me; what 
[DELstart] have I then from[DELend] can 	 can 
[ADDstart] ^[ADDend] who 	 fellow-creatures, who 
nothing. —They 	 nothing? they 
[DELstart] abhor[DELend][ADDstart] ^[ADDend][ADDstart] hate[ADDend] me. 	 hate me. 
 desart 	 desert 
 mourful 	 dreary 
 refuge—I 	 refuge. I 
 days– The 	 days; the 
ice [DELstart] are my[DELend][ADDstart] which[ADDend] I 	 ice, which I 
 fear 	 fear, 
 me 	 me, 
grudge [DELstart] to me[DELend][DELstart] And food[DELend]  – 	 grudge. 
 hail 	 hail, 
[DELstart] man[DELend][DELstart] creatures[DELend][DELstart] and[DELend][DELstart] But I no[DELend][DELstart] They[DELend][DELstart] Man[DELend][DELstart] hates me and i[DELend][DELstart] f[DELend][DELstart] they[DELend][ADDstart] your fellow creatures^[ADDend][ADDstart] beings[ADDend][ADDstart] ^[ADDend][ADDstart] Man[ADDend][ADDstart] s[ADDend] If 	 your fellow-beings. If 
existence [ADDstart] ^[ADDend][ADDstart] they[ADDend]  	 existence, they 
you[ADDstart] ^[ADDend][ADDstart] do[ADDend] arm 	 you do, and arm 
destruction – [DELstart] And[DELend][ADDstart] S[ADDend] hall 	 destruction. Shall 
 me 	 me? 
[ADDstart] ^[ADDend][ADDstart] will[ADDend]  	 will 
[DELstart] temm[DELend]  	[NO 1823 VARIANT]
[DELstart] and[DELend][ADDstart] ^[ADDend][ADDstart] my[ADDend] I 	 my enemies. I 
miserable [ADDstart] &[ADDend]  	 miserable, and 
 wretchedness– 	 wretchedness. 
pow[ADDstart] er[ADDend] to 	 power to 
 me 	 me, 
which[ADDstart] ^[ADDend][ADDstart] it[ADDend]  	 which it 
 & 	 and 
 family 	 family, 
 others 	 others, 
rage.[DELstart] you[DELend][DELstart] have bestowed on them[DELend][ADDstart] you[ADDend] . 	 rage. 
 and justice 	[NO 1823 VARIANT]
 moved 	 moved, 
tale   	 tale: 
that  deny 	 that, abandon 
comiserate[DELstart] d[DELend]  me 	 commiserate me, 
deserve–[ADDstart] .[ADDend]  	 deserve. 
[DELstart] here[DELend][ADDstart] ^[ADDend][ADDstart] hear[ADDend]  me –The 	 hear me. The 
[DELstart] may[DELend]  	[NO 1823 VARIANT]
 allowed 	 allowed, 
[DELstart] are[DELend][ADDstart] may be[ADDend] , 	 are, 
condemned  	 condemned. 
me Frankenstein [DELstart] for you are[DELend] you 	 me, Frankenstein. You 
 muder 	 murder; 
[DELstart] wh[DELend] you would 	 you would, 
[DELstart] s[DELend][DELstart] c[DELend] ed conscience 	 satisfied conscience, 
[DELstart] thy[DELend] thine 	 your 
 creature –Oh 	 creature. Oh, 
man[ADDstart] ![ADDend] —Yet 	 man! Yet 
 me, 	 me: 
[ADDstart] ^[ADDend] can 	 can, 
hands." "Why" cried I–"do 	 hands.”     “Why do 
[DELstart] ever[DELend]  	[NO 1823 VARIANT]
[DELstart] those[DELend]  circumstances 	 remembrance,” I rejoined, “circumstances, 
reflect [DELstart] ever re occured[DELend] that 	 reflect, that 
  – 	 and author? 
[DELstart] night o during which you[DELend] day 	 day, abhorred devil, 
 light, cursed 	 light! Cursed 
 you!— 	 you! 
expression [ADDstart] ^[ADDend] You 	 expression. You 
consider whether 	 consider whether 
 you 	 you, 
no.  begone, 	 not. Begone! 
[DELstart] they[DELend][ADDstart] your[ADDend] Thus 	 the sight of your detested form.”     “Thus 
you, Creator[DELstart] He[DELend][ADDstart] he replied &[ADDend]  	 thee, my creator,” he said, and 
 abhorred 	 hated 
eyes – [DELstart] Thus will I relieve yo[DELend] which 	 eyes, which 
violence[ADDstart] m[ADDend]  the 	 violence; “thus I take from thee a 
 of one whom 	 which 
 abhor.–still you can 	 abhor. Still thou canst 
 me 	 me, 
 your compassion –By the 	 thy compassion. By 
[DELstart] c[DELend] once possessed 	 once possessed, 
[DELstart] Lis[DELend]  	 from you. 
[DELstart] tale[DELend]  tale –It 	 tale; it 
strange [DELstart] but[DELend]  	 strange, 
[DELstart] y[DELend]  	[NO 1823 VARIANT]
on [DELstart] Motan[DELend][DELstart] vert[DELend][ADDstart] the mountain[ADDend]  – 	 upon the mountain. 
 heavens – 	 heavens; 
[DELstart] its lowest[DELend] hide 	 hide 
[DELstart] thes[DELend][ADDstart] yon[ADDend]  mountains 	 yon snowy precipices, 
[ADDstart] a[ADDend][ADDstart] es[ADDend]  	 illuminate 
 world 	 world, 
 story 	 story, 
[DELstart] And[DELend] on 	 On 
 rests 	 rests, 
 habitations 	 neighbourhood 
 man & 	 man, and 
 life 	 life, 
fellow creatures[DELstart] –[DELend] & 	 fellow-creatures, and 
ruin. As 	 ruin.”     As 
 this 	 this, 
 ice –I followed – my 	 ice: I followed. My 
 full 	 full, 
him but [DELstart] when[DELend] as 	 him; but, as 
proceeded  	 proceeded, 
 which 	 that 
[DELstart] I[DELend][DELstart] felt enclined[DELend][ADDstart] ^[ADDend] & I 	 and 
 tale—I 	 tale. I 
[DELstart] As[DELend][DELstart] I was not[DELend]  	 my resolution. 
 brother 	 brother, 
[DELstart] .[DELend] I 	[NO 1823 VARIANT]
 time also 	 time, also, 
 were 	 were, 
 these 	 These 
[DELstart] request[DELend][ADDstart] demand[ADDend]  – 	 demand. 
 ice 	 ice, 
 rock.– 	 rock. 
 cold 	 cold, 
 again 	[NO 1823 VARIANT]
 descend–We 	 descend: we 
 hut – 	 hut, 
 exultation 	 exultation, 
 heart 	 heart, 
 spirits – 	 spirits. 
listen and [DELstart] sitting[DELend] seating 	 listen; and, seating 
he  lighted 	 my odious companion had lighted, 
[DELstart] began[DELend]  	[NO 1823 VARIANT]
